abaisse abaisse	    Adj:Mas+SG
stabilimetre    stabilimetre Nom:Mas+SG
stabilisaient stabiliser Ver:IImp+PL+P3
stabilisais	    stabiliser  Ver:IImp+SG+P1:IImp+SG+P2
stabilisai stabiliser Ver:IPSim+SG+P1
stabilisait	stabiliser Ver:IImp+SG+P3
stabilisames stabiliser	    Ver:IPSim+PL+P1
stabilisant	    stabilisant	Adj:Mas+SG
stabilisant	stabilisant	    Nom:Mas+SG
stabilisant	stabiliser Ver:PPre
stabilisassent  stabiliser Ver:SImp+PL+P3
a	a	Nom:Mas+InvPL
a	a	Pre
a	avoir	Ver:IPre+SG+P3
abaca	abaca	Nom:Mas+SG
abacule	abacule	Nom:Mas+SG
abaissa	abaisser	Ver:IPSim+SG+P3
abaissable	abaissable	Adj:InvGen+SG
abaissai	abaisser	Ver:IPSim+SG+P1
abaissaient	abaisser	Ver:IImp+PL+P3
abaissais	abaisser	Ver:IImp+SG+P1:IImp+SG+P2
abaissait	abaisser	Ver:IImp+SG+P3
abaissames	abaisser	Ver:IPSim+PL+P1
abaissant	abaissant	Adj:Mas+SG
abaissant	abaisser	Ver:PPre
abaissante	abaissant	Adj:Fem+SG
abaissantes	abaissant	Adj:Fem+PL
abaissas	abaisser	Ver:IPSim+SG+P2
abaissasse	abaisser	Ver:SImp+SG+P1
abaissassent	abaisser	Ver:SImp+PL+P3
abaissasses	abaisser	Ver:SImp+SG+P2
abaissassiez	abaisser	Ver:SImp+PL+P2
boutons-d'argent	bouton-d'argent	Nom:Mas+PL
boutons-d'or	bouton-d'or	Nom:Mas+PL
boutons-poussoir	bouton-poussoir	Nom:Mas+PL
boutons-pression	bouton-pression	Nom:Mas+PL
bouton-d'argent	bouton-d'argent	Nom:Mas+SG
bouton-d'or	bouton-d'or	Nom:Mas+SG
abaissassions	abaisser	Ver:SImp+PL+P1
abaissat	abaisser	Ver:SImp+SG+P3
abaissates	abaisser	Ver:IPSim+PL+P2
abaisse	abaisse	Nom:Fem+SG
abaisse	abaisser	Ver:IPre+SG+P1:IPre+SG+P3:SPre+SG+P1:SPre+SG+P3:ImPre+SG+P2
abaisse	abaisser	Ver:PPas+Mas+SG
abaissee	abaisse	Adj:Fem+SG
abaissee	abaissee	Nom:Fem+SG
abaissee	abaisser	Ver:PPas+Fem+SG
abaissees	abaisse	Adj:Fem+PL
abaissees	abaissee	Nom:Fem+PL
abaissees	abaisser	Ver:PPas+Fem+PL
abaissement	abaissement	Nom:Mas+SG
abaissements	abaissement	Nom:Mas+PL
abaissent	abaisser	Ver:IPre+PL+P3:SPre+PL+P3
abaissera	abaisser	Ver:IFut+SG+P3
abaisser	abaisser	Ver:Inf
abaisserai	abaisser	Ver:IFut+SG+P1
abaisseraient	abaisser	Ver:CPre+PL+P3
abaisserais	abaisser	Ver:CPre+SG+P1:CPre+SG+P2
abaisserait	abaisser	Ver:CPre+SG+P3
abaisseras	abaisser	Ver:IFut+SG+P2
abaisserent	abaisser	Ver:IPSim+PL+P3
abaisserez	abaisser	Ver:IFut+PL+P2
abaisseriez	abaisser	Ver:CPre+PL+P2
abaisserions	abaisser	Ver:CPre+PL+P1
abaisserons	abaisser	Ver:IFut+PL+P1
abaisseront	abaisser	Ver:IFut+PL+P3
abaisses	abaisse	Adj:Mas+PL
abaisses	abaisse	Nom:Fem+PL
abaisses	abaisser	Ver:IPre+SG+P2:SPre+SG+P2
abaisses	abaisser	Ver:PPas+Mas+PL
abaisseur	abaisseur	Adj:Mas+SG
abaisseur	abaisseur	Nom:Mas+SG
abaissez	abaisser	Ver:IPre+PL+P2:ImPre+PL+P2
abaisse-langue	abaisse-langue	Nom:Mas+InvPL
abaissiez	abaisser	Ver:IImp+PL+P2:SPre+PL+P2
abaissions	abaisser	Ver:IImp+PL+P1:SPre+PL+P1
abaissons	abaisser	Ver:IPre+PL+P1:ImPre+PL+P1
abajoue	abajoue	Nom:Fem+SG
abandon	abandon	Nom:Mas+SG
abandonna	abandonner	Ver:IPSim+SG+P3
abandonnai	abandonner	Ver:IPSim+SG+P1
abandonnaient	abandonner	Ver:IImp+PL+P3
abandonnais	abandonner	Ver:IImp+SG+P1:IImp+SG+P2
abandonnait	abandonner	Ver:IImp+SG+P3
abandonnames	abandonner	Ver:IPSim+PL+P1
abandonnant	abandonner	Ver:PPre
abandonnant	abandonner	Ver:PPre+Mas+SG
abandonnas	abandonner	Ver:IPSim+SG+P2
abandonnasse	abandonner	Ver:SImp+SG+P1
abandonnassent	abandonner	Ver:SImp+PL+P3
abandonnasses	abandonner	Ver:SImp+SG+P2
abandonnassiez	abandonner	Ver:SImp+PL+P2
abandonnassions	abandonner	Ver:SImp+PL+P1
abandonnat	abandonner	Ver:SImp+SG+P3
abandonnataire	abandonnataire	Nom:InvGen+SG
abandonnates	abandonner	Ver:IPSim+PL+P2
abandonne	abandonne	Adj:Mas+SG
abandonne	abandonne	Nom:Mas+SG
abandonne	abandonner	Ver:IPre+SG+P1:IPre+SG+P3:SPre+SG+P1:SPre+SG+P3:ImPre+SG+P2
abandonne	abandonner	Ver:PPas+Mas+SG
abandonnee	abandonne	Adj:Fem+SG
abandonnee	abandonne	Nom:Fem+SG
abandonnee	abandonner	Ver:PPas+Fem+SG
abandonnees	abandonne	Adj:Fem+PL
abandonnees	abandonne	Nom:Fem+PL
abandonnees	abandonner	Ver:PPas+Fem+PL
abandonnent	abandonner	Ver:IPre+PL+P3:SPre+PL+P3
abandonnera	abandonner	Ver:IFut+SG+P3
abandonner	abandonner	Ver:Inf
abandonnerai	abandonner	Ver:IFut+SG+P1
abandonneraient	abandonner	Ver:CPre+PL+P3
abandonnerais	abandonner	Ver:CPre+SG+P1:CPre+SG+P2
abandonnerait	abandonner	Ver:CPre+SG+P3
abandonneras	abandonner	Ver:IFut+SG+P2
abandonnerent	abandonner	Ver:IPSim+PL+P3
abandonnerez	abandonner	Ver:IFut+PL+P2
abandonneriez	abandonner	Ver:CPre+PL+P2
abandonnerions	abandonner	Ver:CPre+PL+P1
abandonnerons	abandonner	Ver:IFut+PL+P1
abandonneront	abandonner	Ver:IFut+PL+P3
abandonnes	abandonne	Adj:Mas+PL
abandonnes	abandonne	Nom:Mas+PL
abandonnes	abandonner	Ver:IPre+SG+P2:SPre+SG+P2
abandonnes	abandonner	Ver:PPas+Mas+PL
abandonnez	abandonner	Ver:IPre+PL+P2:ImPre+PL+P2
abandonniez	abandonner	Ver:IImp+PL+P2:SPre+PL+P2
abandonnions	abandonner	Ver:IImp+PL+P1:SPre+PL+P1
abandonnique	abandonnique	Adj:InvGen+SG
abandonnons	abandonner	Ver:IPre+PL+P1:ImPre+PL+P1
abandons	abandon	Nom:Mas+PL
abaque	abaque	Nom:Mas+SG
abasourdi	abasourdi	Adj:Mas+SG
abasourdi	abasourdir	Ver:PPas+Mas+SG
abasourdie	abasourdi	Adj:Fem+SG
abasourdie	abasourdir	Ver:PPas+Fem+SG
abasourdies	abasourdi	Adj:Fem+PL
abasourdies	abasourdir	Ver:PPas+Fem+PL
abasourdimes	abasourdir	Ver:IPSim+PL+P1
abasourdira	abasourdir	Ver:IFut+SG+P3
abasourdir	abasourdir	Ver:Inf
abasourdirai	abasourdir	Ver:IFut+SG+P1
abasourdiraient	abasourdir	Ver:CPre+PL+P3
abasourdirais	abasourdir	Ver:CPre+SG+P1:CPre+SG+P2
abasourdirait	abasourdir	Ver:CPre+SG+P3
abasourdiras	abasourdir	Ver:IFut+SG+P2
abasourdirent	abasourdir	Ver:IPSim+PL+P3
abasourdirez	abasourdir	Ver:IFut+PL+P2
abasourdiriez	abasourdir	Ver:CPre+PL+P2
abasourdirions	abasourdir	Ver:CPre+PL+P1
abasourdirons	abasourdir	Ver:IFut+PL+P1
abasourdiront	abasourdir	Ver:IFut+PL+P3
abasourdis	abasourdi	Adj:Mas+PL
abasourdis	abasourdir	Ver:PPas+Mas+PL:IPre+SG+P1:IPre+SG+P2:IPSim+SG+P1:IPSim+SG+P2:ImPre+SG+P2
abasourdissaient	abasourdir	Ver:IImp+PL+P3
abasourdissais	abasourdir	Ver:IImp+SG+P1:IImp+SG+P2
abasourdissait	abasourdir	Ver:IImp+SG+P3
abasourdissant	abasourdir	Ver:PPre
abasourdissant	abasourdir	Ver:PPre
abasourdissant	abasourdir	Ver:PPre+Mas+SG
abasourdissant	abasourdissant	Adj:Mas+SG
abasourdissant	abasourdissant	Adj:Mas+SG
abasourdissante	abasourdissant	Adj:Fem+SG
abasourdissantes	abasourdissant	Adj:Fem+PL
abasourdissants	abasourdissant	Adj:Mas+PL
abasourdisse	abasourdir	Ver:SPre+SG+P1:SPre+SG+P3:SImp+SG+P1
abasourdissement	abasourdissement	Nom:Mas+SG
abasourdissent	abasourdir	Ver:IPre+PL+P3:SPre+PL+P3:SImp+PL+P3
abasourdisses	abasourdir	Ver:SPre+SG+P2:SImp+SG+P2
abasourdissez	abasourdir	Ver:IPre+PL+P2:ImPre+PL+P2
abasourdissiez	abasourdir	Ver:IImp+PL+P2:SPre+PL+P2:SImp+PL+P2
abasourdissions	abasourdir	Ver:IImp+PL+P1:SPre+PL+P1:SImp+PL+P1
abasourdissons	abasourdir	Ver:IPre+PL+P1:ImPre+PL+P1
abasourdit	abasourdir	Ver:IPre+SG+P3:IPSim+SG+P3
abasourdit	abasourdir	Ver:SImp+SG+P3
abasourdites	abasourdir	Ver:IPSim+PL+P2
abat	abat	Nom:Mas+SG
abat	abattre	Ver:IPre+SG+P3
abatage	abatage	Nom:Mas+SG
abatages	abatage	Nom:Mas+PL
abatant	abatant	Nom:Mas+SG
abatardi	abatardir	Ver:PPas
abatardi	abatardir	Ver:PPas+Mas+SG
abatardie	abatardir	Ver:PPas+Fem+SG
abatardies	abatardir	Ver:PPas+Fem+PL
abatardimes	abatardir	Ver:IPSim+PL+P1
abatardira	abatardir	Ver:IFut+SG+P3
abatardir	abatardir	Ver:Inf
abatardirai	abatardir	Ver:IFut+SG+P1
abatardiraient	abatardir	Ver:CPre+PL+P3
abatardirais	abatardir	Ver:CPre+SG+P1
abatardirais	abatardir	Ver:CPre+SG+P2
abatardirait	abatardir	Ver:CPre+SG+P3
abatardiras	abatardir	Ver:IFut+SG+P2
abatardirent	abatardir	Ver:IPSim+PL+P3
abatardirez	abatardir	Ver:IFut+PL+P2
abatardiriez	abatardir	Ver:CPre+PL+P2
abatardirions	abatardir	Ver:CPre+PL+P1
abatardirons	abatardir	Ver:IFut+PL+P1
abatardiront	abatardir	Ver:IFut+PL+P3
abatardis	abatardir	Ver:Imp+SG+P2
abatardis	abatardir	Ver:IPre+SG+P1
abatardis	abatardir	Ver:IPre+SG+P2
abatardis	abatardir	Ver:PPas+Mas+PL
abatardis	abatardir	Ver:IPSim+SG+P1
abatardis	abatardir	Ver:IPSim+SG+P2
abatardissaient	abatardir	Ver:IImp+PL+P3
abatardissais	abatardir	Ver:IImp+SG+P1
abatardissais	abatardir	Ver:IImp+SG+P2
abatardissait	abatardir	Ver:IImp+SG+P3
abatardissant	abatardir	Ver:PPre
abatardissant	abatardir	Ver:PPre+Mas+SG
abatardisse	abatardir	Ver:SImp+SG+P1
abatardisse	abatardir	Ver:SPre+SG+P1
abatardisse	abatardir	Ver:SPre+SG+P3
abatardissement	abatardissement	Nom:Mas+SG
abatardissent	abatardir	Ver:IPre+PL+P3
abatardissent	abatardir	Ver:SImp+PL+P3
abatardissent	abatardir	Ver:SPre+PL+P3
abatardisses	abatardir	Ver:SImp+SG+P2
abatardisses	abatardir	Ver:SPre+SG+P2
abatardissez	abatardir	Ver:Imp+PL+P2
abatardissez	abatardir	Ver:IPre+PL+P2
abatardissiez	abatardir	Ver:IImp+PL+P2
abatardissiez	abatardir	Ver:SImp+PL+P2
abatardissiez	abatardir	Ver:SPre+PL+P2
abatardissions	abatardir	Ver:IImp+PL+P1
abatardissions	abatardir	Ver:SImp+PL+P1
abatardissions	abatardir	Ver:SPre+PL+P1
abatardissons	abatardir	Ver:Imp+PL+P1
abatardissons	abatardir	Ver:IPre+PL+P1
abatardit	abatardir	Ver:IPre+SG+P3
abatardit	abatardir	Ver:IPSim+SG+P3
abatardit	abatardir	Ver:SImp+SG+P3
abatardites	abatardir	Ver:IPSim+PL+P2
abatee	abatee	Nom:Fem+SG
abats	abat	Nom:Mas+PL
abats	abats	Nom:Mas+PL
abats	abattre	Ver:IPre+SG+P1:IPre+SG+P2:ImPre+SG+P2
abattage	abattage	Nom:Mas+SG
abattages	abattage	Nom:Mas+PL
abattaient	abattre	Ver:IImp+PL+P3
abattais	abattre	Ver:IImp+SG+P1:IImp+SG+P2
abduction	abduction	Nom:Fem+SG
abecedaire	abecedaire	Adj:InvGen+SG
abecedaire	abecedaire	Nom:Mas+SG
abecedaires	abecedaire	Adj:InvGen+PL
abecedaires	abecedaire	Nom:Mas+PL
abee	abee	Nom:Fem+SG
abeille	abeille	Nom:Fem+SG
abeilles	abeille	Nom:Fem+PL
abelien	abelien	Adj:Mas+SG
abelienne	abelien	Adj:Fem+SG
abeliennes	abelien	Adj:Fem+PL
abeliens	abelien	Adj:Mas+PL
aber	aber	Nom:Mas+SG
aberrance	aberrance	Nom:Fem+SG
aberrant	aberrant	Adj:Mas+SG
aberrante	aberrant	Adj:Fem+SG
aberrantes	aberrant	Adj:Fem+PL
aberrants	aberrant	Adj:Mas+PL
aberration	aberration	Nom:Fem+SG
aberrations	aberration	Nom:Fem+PL
aberre	aberrer	Ver:Imp+SG+P2
aberre	aberrer	Ver:IPre+SG+P1
aberre	aberrer	Ver:IPre+SG+P3
aberre	aberrer	Ver:SPre+SG+P1
aberre	aberrer	Ver:SPre+SG+P3
aberrer	aberrer	Ver:Inf
abeti	abetir	Ver:PPas+Mas+SG
abetie	abetir	Ver:PPas+Fem+SG
abeties	abetir	Ver:PPas+Fem+PL
abetimes	abetir	Ver:IPSim+PL+P1
abetira	abetir	Ver:IFut+SG+P3
abetir	abetir	Ver:Inf
abetirai	abetir	Ver:IFut+SG+P1
abetiraient	abetir	Ver:CPre+PL+P3
abetirais	abetir	Ver:CPre+SG+P1:CPre+SG+P2
abetirait	abetir	Ver:CPre+SG+P3
abetiras	abetir	Ver:IFut+SG+P2
abetirent	abetir	Ver:IPSim+PL+P3
abetirez	abetir	Ver:IFut+PL+P2
abetiriez	abetir	Ver:CPre+PL+P2
abetirions	abetir	Ver:CPre+PL+P1
abetirons	abetir	Ver:IFut+PL+P1
abetiront	abetir	Ver:IFut+PL+P3
abetis	abetir	Ver:PPas+Mas+PL:IPre+SG+P1:IPre+SG+P2:IPSim+SG+P1:IPSim+SG+P2:ImPre+SG+P2
abetissaient	abetir	Ver:IImp+PL+P3
abetissais	abetir	Ver:IImp+SG+P1:IImp+SG+P2
abetissait	abetir	Ver:IImp+SG+P3
abetissant	abetir	Ver:PPre
abetissant	abetir	Ver:PPre
abetissant	abetir	Ver:PPre+Mas+SG
abetissant	abetissant	Adj:Mas+SG
abetissant	abetissant	Adj:Mas+SG
abetisse	abetir	Ver:SPre+SG+P1:SPre+SG+P3:SImp+SG+P1
abetissement	abetissement	Nom:Mas+SG
abetissent	abetir	Ver:IPre+PL+P3:SPre+PL+P3:SImp+PL+P3
abetisses	abetir	Ver:SPre+SG+P2:SImp+SG+P2
abetissez	abetir	Ver:IPre+PL+P2:ImPre+PL+P2
abetissiez	abetir	Ver:IImp+PL+P2:SPre+PL+P2:SImp+PL+P2
abetissions	abetir	Ver:IImp+PL+P1:SPre+PL+P1:SImp+PL+P1
abetissons	abetir	Ver:IPre+PL+P1:ImPre+PL+P1
abetit	abetir	Ver:IPre+SG+P3:IPSim+SG+P3
abetit	abetir	Ver:SImp+SG+P3
abetites	abetir	Ver:IPSim+PL+P2
abhorra	abhorrer	Ver:IPSim+SG+P3
abhorrai	abhorrer	Ver:IPSim+SG+P1
abhorraient	abhorrer	Ver:IImp+PL+P3
abhorrais	abhorrer	Ver:IImp+SG+P1:IImp+SG+P2
abhorrait	abhorrer	Ver:IImp+SG+P3
abhorrames	abhorrer	Ver:IPSim+PL+P1
abhorrant	abhorrer	Ver:PPre
abhorras	abhorrer	Ver:IPSim+SG+P2
abhorrasse	abhorrer	Ver:SImp+SG+P1
abhorrassent	abhorrer	Ver:SImp+PL+P3
abhorrasses	abhorrer	Ver:SImp+SG+P2
abhorrassiez	abhorrer	Ver:SImp+PL+P2
abhorrassions	abhorrer	Ver:SImp+PL+P1
abhorrat	abhorrer	Ver:SImp+SG+P3
abhorrates	abhorrer	Ver:IPSim+PL+P2
abhorre	abhorrer	Ver:IPre+SG+P1:IPre+SG+P3:SPre+SG+P1:SPre+SG+P3:ImPre+SG+P2
abhorre	abhorrer	Ver:PPas+Mas+SG
abhorrent	abhorrer	Ver:IPre+PL+P3:SPre+PL+P3
abhorrer	abhorrer	Ver:Inf
abhorrerent	abhorrer	Ver:IPSim+PL+P3
abhorres	abhorrer	Ver:IPre+SG+P2:SPre+SG+P2
abhorrez	abhorrer	Ver:IPre+PL+P2:ImPre+PL+P2
abhorriez	abhorrer	Ver:IImp+PL+P2:SPre+PL+P2
abhorrions	abhorrer	Ver:IImp+PL+P1:SPre+PL+P1
abhorrons	abhorrer	Ver:IPre+PL+P1:ImPre+PL+P1
abietin	abietin	Adj:Mas+SG
abietinees	abietinee	Nom:Fem+PL
abima	abimer	Ver:IPSim+SG+P3
abimai	abimer	Ver:IPSim+SG+P1
abimaient	abimer	Ver:IImp+PL+P3
abimais	abimer	Ver:IImp+SG+P1:IImp+SG+P2
abimait	abimer	Ver:IImp+SG+P3
abimames	abimer	Ver:IPSim+PL+P1
abimant	abimant	Adj:Mas+SG
abimant	abimer	Ver:PPre
abimas	abimer	Ver:IPSim+SG+P2
abimasse	abimer	Ver:SImp+SG+P1
abimassent	abimer	Ver:SImp+PL+P3
abimasses	abimer	Ver:SImp+SG+P2
abimassiez	abimer	Ver:SImp+PL+P2
abimassions	abimer	Ver:SImp+PL+P1
abimat	abimer	Ver:SImp+SG+P3
abimates	abimer	Ver:IPSim+PL+P2
abime	abime	Adj:Mas+SG
abime	abime	Nom:Mas+SG
abime	abimer	Ver:IPre+SG+P1:IPre+SG+P3:SPre+SG+P1:SPre+SG+P3:ImPre+SG+P2
abime	abimer	Ver:PPas+Mas+SG
abimee	abime	Adj:Fem+SG
abimee	abimer	Ver:PPas+Fem+SG
abimees	abime	Adj:Fem+PL
abimees	abimer	Ver:PPas+Fem+PL
abiment	abimer	Ver:IPre+PL+P3:SPre+PL+P3
abimera	abimer	Ver:IFut+SG+P3
abimer	abimer	Ver:Inf
abimerai	abimer	Ver:IFut+SG+P1
abimeraient	abimer	Ver:CPre+PL+P3
abimerais	abimer	Ver:CPre+SG+P1:CPre+SG+P2
abimerait	abimer	Ver:CPre+SG+P3
abimeras	abimer	Ver:IFut+SG+P2
abimerent	abimer	Ver:IPSim+PL+P3
abimerez	abimer	Ver:IFut+PL+P2
abimeriez	abimer	Ver:CPre+PL+P2
abimerions	abimer	Ver:CPre+PL+P1
abimerons	abimer	Ver:IFut+PL+P1
abimeront	abimer	Ver:IFut+PL+P3
abimes	abime	Adj:Mas+PL
abimes	abime	Nom:Mas+PL
abimes	abimer	Ver:IPre+SG+P2:SPre+SG+P2
abimes	abimer	Ver:PPas+Mas+PL
abimez	abimer	Ver:IPre+PL+P2:ImPre+PL+P2
abimiez	abimer	Ver:IImp+PL+P2:SPre+PL+P2
abimions	abimer	Ver:IImp+PL+P1:SPre+PL+P1
abimons	abimer	Ver:IPre+PL+P1:ImPre+PL+P1
abiotique	abiotique	Adj:InvGen+SG
abject	abject	Adj:Mas+SG
abjecte	abject	Adj:Fem+SG
abjectement	abjectement	Adv
abjectes	abject	Adj:Fem+PL
abjection	abjection	Nom:Fem+SG
abjections	abjection	Nom:Fem+PL
abjects	abject	Adj:Mas+PL
abjura	abjurer	Ver:IPSim+SG+P3
abjurai	abjurer	Ver:IPSim+SG+P1
abjuraient	abjurer	Ver:IImp+PL+P3
abjurais	abjurer	Ver:IImp+SG+P1:IImp+SG+P2
abjurait	abjurer	Ver:IImp+SG+P3
abjurames	abjurer	Ver:IPSim+PL+P1
abjurant	abjurant	Adj:Mas+SG
abjurant	abjurer	Ver:PPre
abjuras	abjurer	Ver:IPSim+SG+P2
abjurasse	abjurer	Ver:SImp+SG+P1
abjurassent	abjurer	Ver:SImp+PL+P3
abjurasses	abjurer	Ver:SImp+SG+P2
abjurassiez	abjurer	Ver:SImp+PL+P2
abjurassions	abjurer	Ver:SImp+PL+P1
abjurat	abjurer	Ver:SImp+SG+P3
abjurates	abjurer	Ver:IPSim+PL+P2
abjuration	abjuration	Nom:Fem+SG
abjurations	abjuration	Nom:Fem+PL
abjure	abjurer	Ver:IPre+SG+P1:IPre+SG+P3:SPre+SG+P1:SPre+SG+P3:ImPre+SG+P2
abjure	abjurer	Ver:PPas+Mas+SG
abjurent	abjurer	Ver:IPre+PL+P3:SPre+PL+P3
abjurer	abjurer	Ver:Inf
abjurerent	abjurer	Ver:IPSim+PL+P3
abjures	abjurer	Ver:IPre+SG+P2:SPre+SG+P2
abjurez	abjurer	Ver:IPre+PL+P2:ImPre+PL+P2
abjuriez	abjurer	Ver:IImp+PL+P2:SPre+PL+P2
abjurions	abjurer	Ver:IImp+PL+P1:SPre+PL+P1
abjurons	abjurer	Ver:IPre+PL+P1:ImPre+PL+P1
ablata	ablater	Ver:IPSim+SG+P3
ablatai	ablater	Ver:IPSim+SG+P1
ablataient	ablater	Ver:IImp+PL+P3
ablatais	ablater	Ver:IImp+SG+P1:IImp+SG+P2
ablatait	ablater	Ver:IImp+SG+P3
ablatames	ablater	Ver:IPSim+PL+P1
ablatas	ablater	Ver:IPSim+SG+P2
ablatasse	ablater	Ver:SImp+SG+P1
ablatassent	ablater	Ver:SImp+PL+P3
ablatasses	ablater	Ver:SImp+SG+P2
ablatassiez	ablater	Ver:SImp+PL+P2
ablatassions	ablater	Ver:SImp+PL+P1
ablatat	ablater	Ver:SImp+SG+P3
ablatates	ablater	Ver:IPSim+PL+P2
ablate	ablater	Ver:IPre+SG+P1:IPre+SG+P3:SPre+SG+P1:SPre+SG+P3:ImPre+SG+P2
ablatent	ablater	Ver:IPre+PL+P3:SPre+PL+P3
ablatera	ablater	Ver:IFut+SG+P3
ablater	ablater	Ver:Inf
ablaterai	ablater	Ver:IFut+SG+P1
ablateraient	ablater	Ver:CPre+PL+P3
ablaterais	ablater	Ver:CPre+SG+P1:CPre+SG+P2
ablaterait	ablater	Ver:CPre+SG+P3
ablateras	ablater	Ver:IFut+SG+P2
ablaterent	ablater	Ver:IPSim+PL+P3
ablaterez	ablater	Ver:IFut+PL+P2
ablateriez	ablater	Ver:CPre+PL+P2
ablaterions	ablater	Ver:CPre+PL+P1
ablaterons	ablater	Ver:IFut+PL+P1
ablateront	ablater	Ver:IFut+PL+P3
ablates	ablater	Ver:IPre+SG+P2:SPre+SG+P2
ablatez	ablater	Ver:IPre+PL+P2:ImPre+PL+P2
ablatiez	ablater	Ver:IImp+PL+P2:SPre+PL+P2
ablatif	ablatif	Adj:Mas+SG
ablatif	ablatif	Nom:Mas+SG
ablatifs	ablatif	Adj:Mas+PL
ablatifs	ablatif	Nom:Mas+PL
ablation	ablation	Nom:Fem+SG
ablations	ablater	Ver:IImp+PL+P1:SPre+PL+P1
ablations	ablation	Nom:Fem+PL
ablatons	ablater	Ver:IPre+PL+P1:ImPre+PL+P1
able	able	Nom:Mas+SG
ablegat	ablegat	Nom:Mas+SG
ableret	ableret	Nom:Mas+SG
ables	able	Nom:Mas+PL
ablette	ablette	Nom:Fem+SG
ablettes	ablette	Nom:Fem+PL
ablier	ablier	Nom:Mas+SG
ablution	ablution	Nom:Fem+SG
ablutions	ablution	Nom:Fem+PL
ablutions	ablutions	Nom:Fem+PL
abnegation	abnegation	Nom:Fem+SG
abnegations	abnegation	Nom:Fem+PL
aboi	aboi	Nom:Mas+SG
aboie	aboyer	Ver:IPre+SG+P1:IPre+SG+P3:SPre+SG+P1:SPre+SG+P3:ImPre+SG+P2
aboiement	aboiement	Nom:Mas+SG
aboiements	aboiement	Nom:Mas+PL
aboient	aboyer	Ver:IPre+PL+P3:SPre+PL+P3
aboiera	aboyer	Ver:IFut+SG+P3
aboierai	aboyer	Ver:IFut+SG+P1
aboieraient	aboyer	Ver:CPre+PL+P3
aboierais	aboyer	Ver:CPre+SG+P1
aboierais	aboyer	Ver:CPre+SG+P2
aboierait	aboyer	Ver:CPre+SG+P3
aboieras	aboyer	Ver:IFut+SG+P2
aboierez	aboyer	Ver:IFut+PL+P2
aboieriez	aboyer	Ver:CPre+PL+P2
aboierions	aboyer	Ver:CPre+PL+P1
aboierons	aboyer	Ver:IFut+PL+P1
aboieront	aboyer	Ver:IFut+PL+P3
aboies	aboyer	Ver:IPre+SG+P2:SPre+SG+P2
abois	aboi	Nom:Mas+PL
abois	abois	Nom:Mas+PL
aboli	aboli	Adj:Mas+SG
aboli	abolir	Ver:PPas+Mas+SG
abolie	aboli	Adj:Fem+SG
abolie	abolir	Ver:PPas+Fem+SG
abolies	aboli	Adj:Fem+PL
abolies	abolir	Ver:PPas+Fem+PL
abolimes	abolir	Ver:IPSim+PL+P1
abolira	abolir	Ver:IFut+SG+P3
abolir	abolir	Ver:Inf
abolirai	abolir	Ver:IFut+SG+P1
aboliraient	abolir	Ver:CPre+PL+P3
abolirais	abolir	Ver:CPre+SG+P1:CPre+SG+P2
abolirait	abolir	Ver:CPre+SG+P3
aboliras	abolir	Ver:IFut+SG+P2
abolirent	abolir	Ver:IPSim+PL+P3
abolirez	abolir	Ver:IFut+PL+P2
aboliriez	abolir	Ver:CPre+PL+P2
abolirions	abolir	Ver:CPre+PL+P1
abolirons	abolir	Ver:IFut+PL+P1
aboliront	abolir	Ver:IFut+PL+P3
abolis	aboli	Adj:Mas+PL
abolis	abolir	Ver:PPas+Mas+PL:IPre+SG+P1:IPre+SG+P2:IPSim+SG+P1:IPSim+SG+P2:ImPre+SG+P2
abolissaient	abolir	Ver:IImp+PL+P3
abolissais	abolir	Ver:IImp+SG+P1:IImp+SG+P2
abolissait	abolir	Ver:IImp+SG+P3
abolissant	abolir	Ver:PPre
abolissant	abolir	Ver:PPre
abolissant	abolir	Ver:PPre+Mas+SG
abolisse	abolir	Ver:SPre+SG+P1:SPre+SG+P3:SImp+SG+P1
abolissent	abolir	Ver:IPre+PL+P3:SPre+PL+P3:SImp+PL+P3
abolisses	abolir	Ver:SPre+SG+P2:SImp+SG+P2
abolissez	abolir	Ver:IPre+PL+P2:ImPre+PL+P2
abolissiez	abolir	Ver:IImp+PL+P2:SPre+PL+P2:SImp+PL+P2
abolissions	abolir	Ver:IImp+PL+P1:SPre+PL+P1:SImp+PL+P1
abolissons	abolir	Ver:IPre+PL+P1:ImPre+PL+P1
abolit	abolir	Ver:IPre+SG+P3:IPSim+SG+P3
abolit	abolir	Ver:SImp+SG+P3
abolites	abolir	Ver:IPSim+PL+P2
abolition	abolition	Nom:Fem+SG
abolitionnisme	abolitionnisme	Nom:Mas+SG
abolitionniste	abolitionniste	Adj:InvGen+SG
abolitionniste	abolitionniste	Nom:InvGen+SG
abolitionnistes	abolitionniste	Adj:InvGen+PL
abolitionnistes	abolitionniste	Nom:InvGen+PL
abomina	abominer	Ver:IPSim+SG+P3
abominable	abominable	Adj:InvGen+SG
abominablement	abominablement	Adv
abominables	abominable	Adj:InvGen+PL
abominai	abominer	Ver:IPSim+SG+P1
abominaient	abominer	Ver:IImp+PL+P3
abominais	abominer	Ver:IImp+SG+P1:IImp+SG+P2
abominait	abominer	Ver:IImp+SG+P3
abominames	abominer	Ver:IPSim+PL+P1
abominant	abominer	Ver:PPre
abominas	abominer	Ver:IPSim+SG+P2
abominasse	abominer	Ver:SImp+SG+P1
abominassent	abominer	Ver:SImp+PL+P3
abominasses	abominer	Ver:SImp+SG+P2
abominassiez	abominer	Ver:SImp+PL+P2
abominassions	abominer	Ver:SImp+PL+P1
abominat	abominer	Ver:SImp+SG+P3
abominates	abominer	Ver:IPSim+PL+P2
abomination	abomination	Nom:Fem+SG
abominations	abomination	Nom:Fem+PL
abomine	abominer	Ver:IPre+SG+P1:IPre+SG+P3:SPre+SG+P1:SPre+SG+P3:ImPre+SG+P2
abomine	abominer	Ver:PPas+Mas+SG
abominent	abominer	Ver:IPre+PL+P3:SPre+PL+P3
abominer	abominer	Ver:Inf
abominerent	abominer	Ver:IPSim+PL+P3
abomines	abominer	Ver:IPre+SG+P2:SPre+SG+P2
abominez	abominer	Ver:IPre+PL+P2:ImPre+PL+P2
abominiez	abominer	Ver:IImp+PL+P2:SPre+PL+P2
abominions	abominer	Ver:IImp+PL+P1:SPre+PL+P1
abominons	abominer	Ver:IPre+PL+P1:ImPre+PL+P1
abonda	abonder	Ver:IPSim+SG+P3
abondai	abonder	Ver:IPSim+SG+P1
abondaient	abonder	Ver:IImp+PL+P3
abondais	abonder	Ver:IImp+SG+P1:IImp+SG+P2
abondait	abonder	Ver:IImp+SG+P3
abondames	abonder	Ver:IPSim+PL+P1
abondamment	abondamment	Adv
abondance	abondance	Nom:Fem+SG
abondance	abondance	Nom:Mas+SG
abondances	abondance	Nom:Fem+PL
abondances	abondance	Nom:Mas+PL
abondanciste	abondanciste	Adj:InvGen+SG
abondant	abondant	Adj:Mas+SG
abondant	abonder	Ver:PPre
abondante	abondant	Adj:Fem+SG
abondantes	abondant	Adj:Fem+PL
abondants	abondant	Adj:Mas+PL
abondas	abonder	Ver:IPSim+SG+P2
abondasse	abonder	Ver:SImp+SG+P1
abondassent	abonder	Ver:SImp+PL+P3
abondasses	abonder	Ver:SImp+SG+P2
abondassiez	abonder	Ver:SImp+PL+P2
abondassions	abonder	Ver:SImp+PL+P1
abondat	abonder	Ver:SImp+SG+P3
abondates	abonder	Ver:IPSim+PL+P2
abonde	abonder	Ver:IPre+SG+P1:IPre+SG+P3:SPre+SG+P1:SPre+SG+P3:ImPre+SG+P2
abonde	abonder	Ver:PPas+Mas+SG
abondee	abonder	Ver:PPas+Fem+SG
abondees	abonder	Ver:PPas+Fem+PL
abondent	abonder	Ver:IPre+PL+P3:SPre+PL+P3
abondera	abonder	Ver:IFut+SG+P3
abonder	abonder	Ver:Inf
abonderai	abonder	Ver:IFut+SG+P1
abonderaient	abonder	Ver:CPre+PL+P3
abonderais	abonder	Ver:CPre+SG+P1:CPre+SG+P2
abonderait	abonder	Ver:CPre+SG+P3
abonderas	abonder	Ver:IFut+SG+P2
abonderent	abonder	Ver:IPSim+PL+P3
abonderez	abonder	Ver:IFut+PL+P2
abonderiez	abonder	Ver:CPre+PL+P2
abonderions	abonder	Ver:CPre+PL+P1
abonderons	abonder	Ver:IFut+PL+P1
abonderont	abonder	Ver:IFut+PL+P3
abondes	abonder	Ver:IPre+SG+P2:SPre+SG+P2
abondes	abonder	Ver:PPas+Mas+PL
abondez	abonder	Ver:IPre+PL+P2:ImPre+PL+P2
abondiez	abonder	Ver:IImp+PL+P2:SPre+PL+P2
abondions	abonder	Ver:IImp+PL+P1:SPre+PL+P1
abondons	abonder	Ver:IPre+PL+P1:ImPre+PL+P1
abonna	abonner	Ver:IPSim+SG+P3
abonnai	abonner	Ver:IPSim+SG+P1
abonnaient	abonner	Ver:IImp+PL+P3
abonnais	abonner	Ver:IImp+SG+P1:IImp+SG+P2
abonnait	abonner	Ver:IImp+SG+P3
abonnames	abonner	Ver:IPSim+PL+P1
abonnant	abonner	Ver:PPre
abonnas	abonner	Ver:IPSim+SG+P2
abonnasse	abonner	Ver:SImp+SG+P1
abonnassent	abonner	Ver:SImp+PL+P3
abonnasses	abonner	Ver:SImp+SG+P2
abonnassiez	abonner	Ver:SImp+PL+P2
abonnassions	abonner	Ver:SImp+PL+P1
abonnat	abonner	Ver:SImp+SG+P3
abonnates	abonner	Ver:IPSim+PL+P2
abonne	abonne	Adj:Mas+SG
abonne	abonne	Nom:Mas+SG
abonne	abonner	Ver:IPre+SG+P1:IPre+SG+P3:SPre+SG+P1:SPre+SG+P3:ImPre+SG+P2
abonne	abonner	Ver:PPas+Mas+SG
abonnee	abonne	Adj:Fem+SG
abonnee	abonne	Nom:Fem+SG
abonnee	abonner	Ver:PPas+Fem+SG
abonnees	abonne	Adj:Fem+PL
abonnees	abonne	Nom:Fem+PL
abonnees	abonner	Ver:PPas+Fem+PL
abonnement	abonnement	Nom:Mas+SG
abonnements	abonnement	Nom:Mas+PL
abonnent	abonner	Ver:IPre+PL+P3:SPre+PL+P3
abonnera	abonner	Ver:IFut+SG+P3
abonner	abonner	Ver:Inf
abonnerai	abonner	Ver:IFut+SG+P1
abonneraient	abonner	Ver:CPre+PL+P3
abonnerais	abonner	Ver:CPre+SG+P1:CPre+SG+P2
abonnerait	abonner	Ver:CPre+SG+P3
abonneras	abonner	Ver:IFut+SG+P2
abonnerent	abonner	Ver:IPSim+PL+P3
abonnerez	abonner	Ver:IFut+PL+P2
abonneriez	abonner	Ver:CPre+PL+P2
abonnerions	abonner	Ver:CPre+PL+P1
abonnerons	abonner	Ver:IFut+PL+P1
abonneront	abonner	Ver:IFut+PL+P3
abonnes	abonne	Adj:Mas+PL
abonnes	abonne	Nom:Mas+PL
abonnes	abonner	Ver:IPre+SG+P2:SPre+SG+P2
abonnes	abonner	Ver:PPas+Mas+PL
abonnez	abonner	Ver:IPre+PL+P2:ImPre+PL+P2
abonni	abonnir	Ver:PPas+Mas+SG
abonnie	abonnir	Ver:PPas+Fem+SG
abonnies	abonnir	Ver:PPas+Fem+PL
abonniez	abonner	Ver:IImp+PL+P2:SPre+PL+P2
abonnimes	abonnir	Ver:IPSim+PL+P1
abonnions	abonner	Ver:IImp+PL+P1:SPre+PL+P1
abonnira	abonnir	Ver:IFut+SG+P3
abonnir	abonnir	Ver:Inf
abonnirai	abonnir	Ver:IFut+SG+P1
abonniraient	abonnir	Ver:CPre+PL+P3
abonnirais	abonnir	Ver:CPre+SG+P1
abonnirais	abonnir	Ver:CPre+SG+P2
abonnirait	abonnir	Ver:CPre+SG+P3
abonniras	abonnir	Ver:IFut+SG+P2
abonnirent	abonnir	Ver:IPSim+PL+P3
abonnirez	abonnir	Ver:IFut+PL+P2
abonniriez	abonnir	Ver:CPre+PL+P2
abonnirions	abonnir	Ver:CPre+PL+P1
abonnirons	abonnir	Ver:IFut+PL+P1
abonniront	abonnir	Ver:IFut+PL+P3
abonnis	abonnir	Ver:Imp+SG+P2
abonnis	abonnir	Ver:IPre+SG+P1
abonnis	abonnir	Ver:IPre+SG+P2
abonnis	abonnir	Ver:PPas+Mas+PL
abonnis	abonnir	Ver:IPSim+SG+P1
abonnis	abonnir	Ver:IPSim+SG+P2
abonnissaient	abonnir	Ver:IImp+PL+P3
abonnissais	abonnir	Ver:IImp+SG+P1
abonnissais	abonnir	Ver:IImp+SG+P2
abonnissait	abonnir	Ver:IImp+SG+P3
abonnissant	abonnir	Ver:PPre
abonnissant	abonnir	Ver:PPre
abonnissant	abonnir	Ver:PPre+Mas+SG
abonnisse	abonnir	Ver:SImp+SG+P1
abonnisse	abonnir	Ver:SPre+SG+P1
abonnisse	abonnir	Ver:SPre+SG+P3
abonnissement	abonnissement	Nom:Mas+SG
abonnissent	abonnir	Ver:IPre+PL+P3
abonnissent	abonnir	Ver:SImp+PL+P3
abonnissent	abonnir	Ver:SPre+PL+P3
abonnisses	abonnir	Ver:SImp+SG+P2
abonnisses	abonnir	Ver:SPre+SG+P2
abonnissez	abonnir	Ver:Imp+PL+P2
abonnissez	abonnir	Ver:IPre+PL+P2
abonnissiez	abonnir	Ver:IImp+PL+P2
abonnissiez	abonnir	Ver:SImp+PL+P2
abonnissiez	abonnir	Ver:SPre+PL+P2
abonnissions	abonnir	Ver:IImp+PL+P1
abonnissions	abonnir	Ver:SImp+PL+P1
abonnissions	abonnir	Ver:SPre+PL+P1
abonnissons	abonnir	Ver:Imp+PL+P1
abonnissons	abonnir	Ver:IPre+PL+P1
abonnit	abonnir	Ver:IPre+SG+P3
abonnit	abonnir	Ver:IPSim+SG+P3
abonnit	abonnir	Ver:SImp+SG+P3
abonnites	abonnir	Ver:IPSim+PL+P2
abonnons	abonner	Ver:IPre+PL+P1:ImPre+PL+P1
aborda	aborder	Ver:IPSim+SG+P3
abordable	abordable	Adj:InvGen+SG
abordables	abordable	Adj:InvGen+PL
abord	abord	Nom:Mas+SG
abordage	abordage	Nom:Mas+SG
abordages	abordage	Nom:Mas+PL
abordai	aborder	Ver:IPSim+SG+P1
abordaient	aborder	Ver:IImp+PL+P3
abordais	aborder	Ver:IImp+SG+P1:IImp+SG+P2
abordait	aborder	Ver:IImp+SG+P3
abordames	aborder	Ver:IPSim+PL+P1
abordant	aborder	Ver:PPre
abordas	aborder	Ver:IPSim+SG+P2
abordasse	aborder	Ver:SImp+SG+P1
abordassent	aborder	Ver:SImp+PL+P3
abordasses	aborder	Ver:SImp+SG+P2
abordassiez	aborder	Ver:SImp+PL+P2
abordassions	aborder	Ver:SImp+PL+P1
abordat	aborder	Ver:SImp+SG+P3
abordates	aborder	Ver:IPSim+PL+P2
aborde	aborde	Adj:Mas+SG
aborde	aborder	Ver:IPre+SG+P1:IPre+SG+P3:SPre+SG+P1:SPre+SG+P3:ImPre+SG+P2
abordee	aborde	Adj:Fem+SG
abordee	aborder	Ver:PPas+Fem+SG
abordees	aborde	Adj:Fem+PL
abordees	aborder	Ver:PPas+Fem+PL
abordent	aborder	Ver:IPre+PL+P3:SPre+PL+P3
abordera	aborder	Ver:IFut+SG+P3
aborder	aborder	Ver:Inf
aborderai	aborder	Ver:IFut+SG+P1
aborderaient	aborder	Ver:CPre+PL+P3
aborderais	aborder	Ver:CPre+SG+P1:CPre+SG+P2
aborderait	aborder	Ver:CPre+SG+P3
aborderas	aborder	Ver:IFut+SG+P2
aborderent	aborder	Ver:IPSim+PL+P3
aborderez	aborder	Ver:IFut+PL+P2
aborderiez	aborder	Ver:CPre+PL+P2
aborderions	aborder	Ver:CPre+PL+P1
aborderons	aborder	Ver:IFut+PL+P1
aborderont	aborder	Ver:IFut+PL+P3
abordes	aborde	Adj:Mas+PL
abordes	aborde	Nom:Mas+PL
abordes	aborder	Ver:IPre+SG+P2:SPre+SG+P2
abordes	aborder	Ver:PPas+Mas+PL
abordez	aborder	Ver:IPre+PL+P2:ImPre+PL+P2
abordiez	aborder	Ver:IImp+PL+P2:SPre+PL+P2
abordions	aborder	Ver:IImp+PL+P1:SPre+PL+P1
abordons	aborder	Ver:IPre+PL+P1:ImPre+PL+P1
abords	abord	Nom:Mas+PL
abords	abords	Nom:Mas+PL
aborigene	aborigene	Adj:InvGen+SG
aborigene	aborigene	Nom:InvGen+SG
aborigenes	aborigene	Adj:InvGen+PL
aborigenes	aborigene	Nom:InvGen+PL
abornant	aborner	Ver:PPre
abornant	aborner	Ver:PPre+Mas+SG
aborne	aborner	Ver:Imp+SG+P2
aborne	aborner	Ver:IPre+SG+P1
aborne	aborner	Ver:IPre+SG+P3
aborne	aborner	Ver:SPre+SG+P1
aborne	aborner	Ver:SPre+SG+P3
aborner	aborner	Ver:Inf
abortif	abortif	Adj:Mas+SG
abortif	abortif	Nom:Mas+SG
abortive	abortif	Adj:Fem+SG
abortives	abortif	Adj:Fem+PL
abot	abot	Nom:Mas+SG
aboucha	aboucher	Ver:IPSim+SG+P3
abouchai	aboucher	Ver:IPSim+SG+P1
abouchaient	aboucher	Ver:IImp+PL+P3
abouchais	aboucher	Ver:IImp+SG+P1:IImp+SG+P2
abouchait	aboucher	Ver:IImp+SG+P3
abouchames	aboucher	Ver:IPSim+PL+P1
abouchant	aboucher	Ver:PPre
abouchas	aboucher	Ver:IPSim+SG+P2
abouchasse	aboucher	Ver:SImp+SG+P1
abouchassent	aboucher	Ver:SImp+PL+P3
abouchasses	aboucher	Ver:SImp+SG+P2
abouchassiez	aboucher	Ver:SImp+PL+P2
abouchassions	aboucher	Ver:SImp+PL+P1
abouchat	aboucher	Ver:SImp+SG+P3
abouchates	aboucher	Ver:IPSim+PL+P2
abouche	aboucher	Ver:IPre+SG+P1:IPre+SG+P3:SPre+SG+P1:SPre+SG+P3:ImPre+SG+P2
abouche	aboucher	Ver:PPas+Mas+SG
abouchement	abouchement	Nom:Mas+SG
abouchent	aboucher	Ver:IPre+PL+P3:SPre+PL+P3
aboucher	aboucher	Ver:Inf
aboucherent	aboucher	Ver:IPSim+PL+P3
abouches	aboucher	Ver:IPre+SG+P2:SPre+SG+P2
abouchez	aboucher	Ver:IPre+PL+P2:ImPre+PL+P2
abouchiez	aboucher	Ver:IImp+PL+P2:SPre+PL+P2
abouchions	aboucher	Ver:IImp+PL+P1:SPre+PL+P1
abouchons	aboucher	Ver:IPre+PL+P1:ImPre+PL+P1
aboule	abouler	Ver:Imp+SG+P2
aboule	abouler	Ver:IPre+SG+P1
aboule	abouler	Ver:IPre+SG+P3
aboule	abouler	Ver:SPre+SG+P1
aboule	abouler	Ver:SPre+SG+P3
abouler	abouler	Ver:Inf
aboules	abouler	Ver:PPas+Mas+PL
aboulez	abouler	Ver:Imp+PL+P2
aboulez	abouler	Ver:IPre+PL+P2
aboulie	aboulie	Nom:Fem+SG
aboulique	aboulique	Adj:InvGen+SG
aboulique	aboulique	Nom:InvGen+SG
abouta	abouter	Ver:IPSim+SG+P3
about	about	Nom:Mas+SG
aboutai	abouter	Ver:IPSim+SG+P1
aboutaient	abouter	Ver:IImp+PL+P3
aboutais	abouter	Ver:IImp+SG+P1:IImp+SG+P2
aboutait	abouter	Ver:IImp+SG+P3
aboutames	abouter	Ver:IPSim+PL+P1
aboutant	abouter	Ver:PPre
aboutas	abouter	Ver:IPSim+SG+P2
aboutasse	abouter	Ver:SImp+SG+P1
aboutassent	abouter	Ver:SImp+PL+P3
aboutasses	abouter	Ver:SImp+SG+P2
aboutassiez	abouter	Ver:SImp+PL+P2
aboutassions	abouter	Ver:SImp+PL+P1
aboutat	abouter	Ver:SImp+SG+P3
aboutates	abouter	Ver:IPSim+PL+P2
aboute	aboute	Adj:Mas+SG
aboute	abouter	Ver:IPre+SG+P1:IPre+SG+P3:SPre+SG+P1:SPre+SG+P3:ImPre+SG+P2
aboute	abouter	Ver:PPas+Mas+SG
aboutement	aboutement	Nom:Mas+SG
aboutent	abouter	Ver:IPre+PL+P3:SPre+PL+P3
abouter	abouter	Ver:Inf
abouterent	abouter	Ver:IPSim+PL+P3
aboutes	abouter	Ver:IPre+SG+P2:SPre+SG+P2
aboutez	abouter	Ver:IPre+PL+P2:ImPre+PL+P2
abouti	aboutir	Ver:PPas+Mas+SG
aboutie	abouti	Adj:Fem+SG
aboutie	aboutir	Ver:PPas+Fem+SG
abouties	abouti	Adj:Fem+PL
abouties	aboutir	Ver:PPas+Fem+PL
aboutiez	abouter	Ver:IImp+PL+P2:SPre+PL+P2
aboutimes	aboutir	Ver:IPSim+PL+P1
aboutions	abouter	Ver:IImp+PL+P1:SPre+PL+P1
aboutira	aboutir	Ver:IFut+SG+P3
aboutir	aboutir	Ver:Inf
aboutirai	aboutir	Ver:IFut+SG+P1
aboutiraient	aboutir	Ver:CPre+PL+P3
aboutirais	aboutir	Ver:CPre+SG+P1:CPre+SG+P2
aboutirait	aboutir	Ver:CPre+SG+P3
aboutiras	aboutir	Ver:IFut+SG+P2
aboutirent	aboutir	Ver:IPSim+PL+P3
aboutirez	aboutir	Ver:IFut+PL+P2
aboutiriez	aboutir	Ver:CPre+PL+P2
aboutirions	aboutir	Ver:CPre+PL+P1
aboutirons	aboutir	Ver:IFut+PL+P1
aboutiront	aboutir	Ver:IFut+PL+P3
aboutis	aboutir	Ver:IPre+SG+P1:IPre+SG+P2:IPSim+SG+P1:IPSim+SG+P2:ImPre+SG+P2
aboutissaient	aboutir	Ver:IImp+PL+P3
aboutissais	aboutir	Ver:IImp+SG+P1:IImp+SG+P2
aboutissait	aboutir	Ver:IImp+SG+P3
aboutissant	aboutir	Ver:PPre
aboutissant	aboutir	Ver:PPre
aboutissant	aboutir	Ver:PPre+Mas+SG
aboutissant	aboutissant	Adj:Mas+SG
aboutissants	aboutissant	Adj:Mas+PL
aboutissants	aboutissants	Nom:Mas+PL
aboutisse	aboutir	Ver:SPre+SG+P1:SPre+SG+P3:SImp+SG+P1
aboutissement	aboutissement	Nom:Mas+SG
aboutissements	aboutissement	Nom:Mas+PL
aboutissent	aboutir	Ver:IPre+PL+P3:SPre+PL+P3:SImp+PL+P3
aboutisses	aboutir	Ver:SPre+SG+P2:SImp+SG+P2
aboutissez	aboutir	Ver:IPre+PL+P2:ImPre+PL+P2
aboutissiez	aboutir	Ver:IImp+PL+P2:SPre+PL+P2:SImp+PL+P2
aboutissions	aboutir	Ver:IImp+PL+P1:SPre+PL+P1:SImp+PL+P1
aboutissons	aboutir	Ver:IPre+PL+P1:ImPre+PL+P1
aboutit	aboutir	Ver:IPre+SG+P3:IPSim+SG+P3
aboutit	aboutir	Ver:SImp+SG+P3
aboutites	aboutir	Ver:IPSim+PL+P2
aboutons	abouter	Ver:IPre+PL+P1:ImPre+PL+P1
aboya	aboyer	Ver:IPSim+SG+P3
aboyai	aboyer	Ver:IPSim+SG+P1
aboyaient	aboyer	Ver:IImp+PL+P3
aboyais	aboyer	Ver:IImp+SG+P1:IImp+SG+P2
aboyait	aboyer	Ver:IImp+SG+P3
aboyames	aboyer	Ver:IPSim+PL+P1
aboyant	aboyer	Ver:PPre
aboyas	aboyer	Ver:IPSim+SG+P2
aboyasse	aboyer	Ver:SImp+SG+P1
aboyassent	aboyer	Ver:SImp+PL+P3
aboyasses	aboyer	Ver:SImp+SG+P2
aboyassiez	aboyer	Ver:SImp+PL+P2
aboyassions	aboyer	Ver:SImp+PL+P1
aboyat	aboyer	Ver:SImp+SG+P3
aboyates	aboyer	Ver:IPSim+PL+P2
aboye	aboyer	Ver:PPas+Mas+SG
aboyee	aboyer	Ver:PPas+Fem+SG
aboyees	aboyer	Ver:PPas+Fem+PL
aboyer	aboyer	Ver:Inf
aboyerent	aboyer	Ver:IPSim+PL+P3
aboyes	aboyer	Ver:PPas+Mas+PL
aboyeur	aboyeur	Nom:Mas+SG
aboyeuse	aboyeur	Nom:Fem+SG
aboyez	aboyer	Ver:IPre+PL+P2:ImPre+PL+P2
aboyiez	aboyer	Ver:IImp+PL+P2:SPre+PL+P2
aboyions	aboyer	Ver:IImp+PL+P1:SPre+PL+P1
aboyons	aboyer	Ver:IPre+PL+P1:ImPre+PL+P1
abracadabrant	abracadabrant	Adj:Mas+SG
abracadabrante	abracadabrant	Adj:Fem+SG
abracadabrantes	abracadabrant	Adj:Fem+PL
abracadabrants	abracadabrant	Adj:Mas+PL
abrasa	abraser	Ver:IPSim+SG+P3
abrasai	abraser	Ver:IPSim+SG+P1
abrasaient	abraser	Ver:IImp+PL+P3
abrasais	abraser	Ver:IImp+SG+P1:IImp+SG+P2
abrasait	abraser	Ver:IImp+SG+P3
abrasames	abraser	Ver:IPSim+PL+P1
abrasant	abraser	Ver:PPre
abrasas	abraser	Ver:IPSim+SG+P2
abrasasse	abraser	Ver:SImp+SG+P1
abrasassent	abraser	Ver:SImp+PL+P3
abrasasses	abraser	Ver:SImp+SG+P2
abrasassiez	abraser	Ver:SImp+PL+P2
abrasassions	abraser	Ver:SImp+PL+P1
abrasat	abraser	Ver:SImp+SG+P3
abrasates	abraser	Ver:IPSim+PL+P2
abrase	abraser	Ver:IPre+SG+P1:IPre+SG+P3:SPre+SG+P1:SPre+SG+P3:ImPre+SG+P2
abrase	abraser	Ver:PPas+Mas+SG
abrasent	abraser	Ver:IPre+PL+P3:SPre+PL+P3
abraser	abraser	Ver:Inf
abraserent	abraser	Ver:IPSim+PL+P3
abrases	abraser	Ver:IPre+SG+P2:SPre+SG+P2
abrasez	abraser	Ver:IPre+PL+P2:ImPre+PL+P2
abrasiez	abraser	Ver:IImp+PL+P2:SPre+PL+P2
abrasif	abrasif	Adj:Mas+SG
abrasif	abrasif	Nom:Mas+SG
abrasifs	abrasif	Adj:Mas+PL
abrasifs	abrasif	Nom:Mas+PL
abrasion	abrasion	Nom:Fem+SG
abrasions	abraser	Ver:IImp+PL+P1:SPre+PL+P1
abrasions	abrasion	Nom:Fem+PL
abrasive	abrasif	Adj:Fem+SG
abrasives	abrasif	Adj:Fem+PL
abrasons	abraser	Ver:IPre+PL+P1:ImPre+PL+P1
abreaction	abreaction	Nom:Fem+SG
abreactions	abreaction	Nom:Fem+PL
abregea	abreger	Ver:IPSim+SG+P3
abrege	abrege	Nom:Mas+SG
abrege	abreger	Ver:IPre+SG+P1:IPre+SG+P3:SPre+SG+P1:SPre+SG+P3:ImPre+SG+P2
abrege	abreger	Ver:PPas+Mas+SG
abregeai	abreger	Ver:IPSim+SG+P1
abregeaient	abreger	Ver:IImp+PL+P3
abregeais	abreger	Ver:IImp+SG+P1:IImp+SG+P2
abregeait	abreger	Ver:IImp+SG+P3
abregeames	abreger	Ver:IPSim+PL+P1
abregeant	abreger	Ver:PPre
abregeas	abreger	Ver:IPSim+SG+P2
abregeasse	abreger	Ver:SImp+SG+P1
abregeassent	abreger	Ver:SImp+PL+P3
abregeasses	abreger	Ver:SImp+SG+P2
abregeassiez	abreger	Ver:SImp+PL+P2
abregeassions	abreger	Ver:SImp+PL+P1
abregeat	abreger	Ver:SImp+SG+P3
abregeates	abreger	Ver:IPSim+PL+P2
abregee	abreger	Ver:PPas+Fem+SG
abregees	abreger	Ver:PPas+Fem+PL
abregement	abregement	Nom:Mas+SG
abregement	abregement	Nom:Mas+SG
abregent	abreger	Ver:IPre+PL+P3:SPre+PL+P3
abregeons	abreger	Ver:IPre+PL+P1:ImPre+PL+P1
abregera	abreger	Ver:IFut+SG+P3
abreger	abreger	Ver:Inf
abregerai	abreger	Ver:IFut+SG+P1
abregeraient	abreger	Ver:CPre+PL+P3
abregerais	abreger	Ver:CPre+SG+P1:CPre+SG+P2
abregerait	abreger	Ver:CPre+SG+P3
abregeras	abreger	Ver:IFut+SG+P2
abregerent	abreger	Ver:IPSim+PL+P3
abregerez	abreger	Ver:IFut+PL+P2
abregeriez	abreger	Ver:CPre+PL+P2
abregerions	abreger	Ver:CPre+PL+P1
abregerons	abreger	Ver:IFut+PL+P1
abregeront	abreger	Ver:IFut+PL+P3
abreges	abrege	Nom:Mas+PL
abreges	abreger	Ver:IPre+SG+P2:SPre+SG+P2
abreges	abreger	Ver:PPas+Mas+PL
abregez	abreger	Ver:IPre+PL+P2:ImPre+PL+P2
abregiez	abreger	Ver:IImp+PL+P2:SPre+PL+P2
abregions	abreger	Ver:IImp+PL+P1:SPre+PL+P1
abreuva	abreuver	Ver:IPSim+SG+P3
abreuvai	abreuver	Ver:IPSim+SG+P1
abreuvaient	abreuver	Ver:IImp+PL+P3
abreuvais	abreuver	Ver:IImp+SG+P1:IImp+SG+P2
abreuvait	abreuver	Ver:IImp+SG+P3
abreuvames	abreuver	Ver:IPSim+PL+P1
abreuvant	abreuver	Ver:PPre
abreuvas	abreuver	Ver:IPSim+SG+P2
abreuvasse	abreuver	Ver:SImp+SG+P1
abreuvassent	abreuver	Ver:SImp+PL+P3
abreuvasses	abreuver	Ver:SImp+SG+P2
abreuvassiez	abreuver	Ver:SImp+PL+P2
abreuvassions	abreuver	Ver:SImp+PL+P1
abreuvat	abreuver	Ver:SImp+SG+P3
abreuvates	abreuver	Ver:IPSim+PL+P2
abreuve	abreuver	Ver:IPre+SG+P1:IPre+SG+P3:SPre+SG+P1:SPre+SG+P3:ImPre+SG+P2
abreuve	abreuver	Ver:PPas+Mas+SG
abreuvent	abreuver	Ver:IPre+PL+P3:SPre+PL+P3
abreuver	abreuver	Ver:Inf
abreuverent	abreuver	Ver:IPSim+PL+P3
abreuves	abreuver	Ver:IPre+SG+P2:SPre+SG+P2
abreuvez	abreuver	Ver:IPre+PL+P2:ImPre+PL+P2
abreuviez	abreuver	Ver:IImp+PL+P2:SPre+PL+P2
abreuvions	abreuver	Ver:IImp+PL+P1:SPre+PL+P1
abreuvoir	abreuvoir	Nom:Mas+SG
abreuvoirs	abreuvoir	Nom:Mas+PL
abreuvons	abreuver	Ver:IPre+PL+P1:ImPre+PL+P1
abreviatif	abreviatif	Adj:Mas+SG
abreviation	abreviation	Nom:Fem+SG
abreviations	abreviation	Nom:Fem+PL
abreviative	abreviatif	Adj:Fem+SG
abreviativement	abreviativement	Adv
abreviatives	abreviatif	Adj:Fem+PL
abri	abri	Nom:Mas+SG
abricot	abricot	Adj:InvGen+SG:InvGen+PL
abricot	abricot	Nom:Mas+SG
abricote	abricote	Adj:Mas+SG
abricote	abricote	Nom:Mas+SG
abricote	abricoter	Ver:PPas+Mas+SG
abricotee	abricote	Adj:Fem+SG
abricotee	abricoter	Ver:PPas+Fem+SG
abricotees	abricote	Adj:Fem+PL
abricotees	abricoter	Ver:PPas+Fem+PL
abricotez	abricoter	Ver:Imp+PL+P2
abricotez	abricoter	Ver:IPre+PL+P2
abricotier	abricotier	Nom:Mas+SG
abricotiers	abricotier	Nom:Mas+PL
abricots	abricot	Nom:Mas+PL
abris	abri	Nom:Mas+PL
abris-sous-roche	abri-sous-roche	Nom:Mas+PL
abrita	abriter	Ver:IPSim+SG+P3
abritai	abriter	Ver:IPSim+SG+P1
abritaient	abriter	Ver:IImp+PL+P3
abritais	abriter	Ver:IImp+SG+P1:IImp+SG+P2
abritait	abriter	Ver:IImp+SG+P3
abritames	abriter	Ver:IPSim+PL+P1
abritant	abriter	Ver:PPre
abritas	abriter	Ver:IPSim+SG+P2
abritasse	abriter	Ver:SImp+SG+P1
abritassent	abriter	Ver:SImp+PL+P3
abritasses	abriter	Ver:SImp+SG+P2
abritassiez	abriter	Ver:SImp+PL+P2
abritassions	abriter	Ver:SImp+PL+P1
abritat	abriter	Ver:SImp+SG+P3
abritates	abriter	Ver:IPSim+PL+P2
abrite	abrite	Adj:Mas+SG
abrite	abriter	Ver:IPre+SG+P1:IPre+SG+P3:SPre+SG+P1:SPre+SG+P3:ImPre+SG+P2
abrite	abriter	Ver:PPas+Mas+SG
abritee	abrite	Adj:Fem+SG
abritees	abrite	Adj:Fem+PL
abritent	abriter	Ver:IPre+PL+P3:SPre+PL+P3
abritera	abriter	Ver:IFut+SG+P3
abriter	abriter	Ver:Inf
abriterai	abriter	Ver:IFut+SG+P1
abriteraient	abriter	Ver:CPre+PL+P3
abriterais	abriter	Ver:CPre+SG+P1:CPre+SG+P2
abriterait	abriter	Ver:CPre+SG+P3
abriteras	abriter	Ver:IFut+SG+P2
abriterent	abriter	Ver:IPSim+PL+P3
abriterez	abriter	Ver:IFut+PL+P2
abriteriez	abriter	Ver:CPre+PL+P2
abriterions	abriter	Ver:CPre+PL+P1
abriterons	abriter	Ver:IFut+PL+P1
abriteront	abriter	Ver:IFut+PL+P3
abrites	abrite	Adj:Mas+PL
abrites	abriter	Ver:IPre+SG+P2:SPre+SG+P2
abrites	abriter	Ver:PPas+Mas+PL
abritez	abriter	Ver:IPre+PL+P2:ImPre+PL+P2
abritiez	abriter	Ver:IImp+PL+P2:SPre+PL+P2
abritions	abriter	Ver:IImp+PL+P1:SPre+PL+P1
abritons	abriter	Ver:IPre+PL+P1:ImPre+PL+P1
abrivent	abrivent	Nom:Mas+SG
abri-sous-roche	abri-sous-roche	Nom:Mas+SG
abrogatif	abrogatif	Adj:Mas+SG
abrogation	abrogation	Nom:Fem+SG
abrogations	abrogation	Nom:Fem+PL
abrogative	abrogatif	Adj:Fem+SG
abrogatives	abrogatif	Adj:Fem+PL
abrogatoire	abrogatoire	Adj:InvGen+SG
abrogea	abroger	Ver:IPSim+SG+P3
abrogeable	abrogeable	Adj:InvGen+SG
abrogeables	abrogeable	Adj:InvGen+PL
abroge	abroger	Ver:IPre+SG+P1:IPre+SG+P3:SPre+SG+P1:SPre+SG+P3:ImPre+SG+P2
abroge	abroger	Ver:PPas+Mas+SG
abrogeai	abroger	Ver:IPSim+SG+P1
abrogeaient	abroger	Ver:IImp+PL+P3
abrogeais	abroger	Ver:IImp+SG+P1:IImp+SG+P2
abrogeait	abroger	Ver:IImp+SG+P3
abrogeames	abroger	Ver:IPSim+PL+P1
abrogeant	abroger	Ver:PPre
abrogeas	abroger	Ver:IPSim+SG+P2
abrogeasse	abroger	Ver:SImp+SG+P1
abrogeassent	abroger	Ver:SImp+PL+P3
abrogeasses	abroger	Ver:SImp+SG+P2
abrogeassiez	abroger	Ver:SImp+PL+P2
abrogeassions	abroger	Ver:SImp+PL+P1
abrogeat	abroger	Ver:SImp+SG+P3
abrogeates	abroger	Ver:IPSim+PL+P2
abrogee	abroger	Ver:PPas+Fem+SG
abrogees	abroger	Ver:PPas+Fem+PL
abrogent	abroger	Ver:IPre+PL+P3:SPre+PL+P3
abrogeons	abroger	Ver:IPre+PL+P1:ImPre+PL+P1
abrogera	abroger	Ver:IFut+SG+P3
abroger	abroger	Ver:Inf
abrogerai	abroger	Ver:IFut+SG+P1
abrogeraient	abroger	Ver:CPre+PL+P3
abrogerais	abroger	Ver:CPre+SG+P1:CPre+SG+P2
abrogerait	abroger	Ver:CPre+SG+P3
abrogeras	abroger	Ver:IFut+SG+P2
abrogerent	abroger	Ver:IPSim+PL+P3
abrogerez	abroger	Ver:IFut+PL+P2
abrogeriez	abroger	Ver:CPre+PL+P2
abrogerions	abroger	Ver:CPre+PL+P1
abrogerons	abroger	Ver:IFut+PL+P1
abrogeront	abroger	Ver:IFut+PL+P3
abroges	abroger	Ver:IPre+SG+P2:SPre+SG+P2
abroges	abroger	Ver:PPas+Mas+PL
abrogez	abroger	Ver:IPre+PL+P2:ImPre+PL+P2
abrogiez	abroger	Ver:IImp+PL+P2:SPre+PL+P2
abrogions	abroger	Ver:IImp+PL+P1:SPre+PL+P1
abrupt	abrupt	Adj:Mas+SG
abrupt	abrupt	Nom:Mas+SG
abrupte	abrupt	Adj:Fem+SG
abruptement	abruptement	Adv
abruptes	abrupt	Adj:Fem+PL
abrupts	abrupt	Adj:Mas+PL
abrupts	abrupt	Nom:Mas+PL
abruti	abruti	Adj:Mas+SG
abruti	abruti	Nom:Mas+SG
abruti	abrutir	Ver:PPas+Mas+SG
abrutie	abruti	Adj:Fem+SG
abrutie	abruti	Nom:Fem+SG
abrutie	abrutir	Ver:PPas+Fem+SG
abruties	abruti	Adj:Fem+PL
abruties	abruti	Nom:Fem+PL
abruties	abrutir	Ver:PPas+Fem+PL
abrutimes	abrutir	Ver:IPSim+PL+P1
abrutira	abrutir	Ver:IFut+SG+P3
abrutir	abrutir	Ver:Inf
abrutirai	abrutir	Ver:IFut+SG+P1
abrutiraient	abrutir	Ver:CPre+PL+P3
abrutirais	abrutir	Ver:CPre+SG+P1:CPre+SG+P2
abrutirait	abrutir	Ver:CPre+SG+P3
abrutiras	abrutir	Ver:IFut+SG+P2
abrutirent	abrutir	Ver:IPSim+PL+P3
abrutirez	abrutir	Ver:IFut+PL+P2
abrutiriez	abrutir	Ver:CPre+PL+P2
abrutirions	abrutir	Ver:CPre+PL+P1
abrutirons	abrutir	Ver:IFut+PL+P1
abrutiront	abrutir	Ver:IFut+PL+P3
abrutis	abruti	Adj:Mas+PL
abrutis	abruti	Nom:Mas+PL
abrutis	abrutir	Ver:PPas+Mas+PL:IPre+SG+P1:IPre+SG+P2:IPSim+SG+P1:IPSim+SG+P2:ImPre+SG+P2
abrutissaient	abrutir	Ver:IImp+PL+P3
abrutissais	abrutir	Ver:IImp+SG+P1:IImp+SG+P2
abrutissait	abrutir	Ver:IImp+SG+P3
abrutissant	abrutir	Ver:PPre
abrutissant	abrutir	Ver:PPre
abrutissant	abrutir	Ver:PPre+Mas+SG
abrutissant	abrutissant	Adj:Mas+SG
abrutissant	abrutissant	Adj:Mas+SG
abrutissante	abrutissant	Adj:Fem+SG
abrutissantes	abrutissant	Adj:Fem+PL
abrutissants	abrutissant	Adj:Mas+PL
abrutisse	abrutir	Ver:SPre+SG+P1:SPre+SG+P3:SImp+SG+P1
abrutissement	abrutissement	Nom:Mas+SG
abrutissent	abrutir	Ver:IPre+PL+P3:SPre+PL+P3:SImp+PL+P3
abrutisses	abrutir	Ver:SPre+SG+P2:SImp+SG+P2
abrutissez	abrutir	Ver:IPre+PL+P2:ImPre+PL+P2
abrutissiez	abrutir	Ver:IImp+PL+P2:SPre+PL+P2:SImp+PL+P2
abrutissions	abrutir	Ver:IImp+PL+P1:SPre+PL+P1:SImp+PL+P1
abrutissons	abrutir	Ver:IPre+PL+P1:ImPre+PL+P1
abrutit	abrutir	Ver:IPre+SG+P3:IPSim+SG+P3
abrutit	abrutir	Ver:SImp+SG+P3
abrutites	abrutir	Ver:IPSim+PL+P2
abscisse	abscisse	Nom:Fem+SG
abscisses	abscisse	Nom:Fem+PL
abscons	abscons	Adj:Mas+InvPL
absconse	abscons	Adj:Fem+SG
absconse	absconse	Nom:Fem+SG
absence	absence	Nom:Fem+SG
absences	absence	Nom:Fem+PL
absenta	absenter	Ver:IPSim+SG+P3
absent	absent	Adj:Mas+SG
absentai	absenter	Ver:IPSim+SG+P1
absentaient	absenter	Ver:IImp+PL+P3
absentais	absenter	Ver:IImp+SG+P1:IImp+SG+P2
absentait	absenter	Ver:IImp+SG+P3
absentames	absenter	Ver:IPSim+PL+P1
absentant	absenter	Ver:PPre
absentas	absenter	Ver:IPSim+SG+P2
absentasse	absenter	Ver:SImp+SG+P1
absentassent	absenter	Ver:SImp+PL+P3
absentasses	absenter	Ver:SImp+SG+P2
absentassiez	absenter	Ver:SImp+PL+P2
absentassions	absenter	Ver:SImp+PL+P1
absentat	absenter	Ver:SImp+SG+P3
absentates	absenter	Ver:IPSim+PL+P2
absente	absent	Adj:Fem+SG
absente	absenter	Ver:IPre+SG+P1:IPre+SG+P3:SPre+SG+P1:SPre+SG+P3:ImPre+SG+P2
absente	absenter	Ver:PPas+Mas+SG
absente	absent	Nom:Fem+SG
absentee	absenter	Ver:PPas+Fem+SG
absentees	absenter	Ver:PPas+Fem+PL
absenteisme	absenteisme	Nom:Mas+SG
absenteiste	absenteiste	Adj:InvGen+SG
absenteiste	absenteiste	Nom:InvGen+SG
absenteistes	absenteiste	Adj:InvGen+PL
absenteistes	absenteiste	Nom:InvGen+PL
absentent	absenter	Ver:IPre+PL+P3:SPre+PL+P3
absentera	absenter	Ver:IFut+SG+P3
absenter	absenter	Ver:Inf
absenterai	absenter	Ver:IFut+SG+P1
absenteraient	absenter	Ver:CPre+PL+P3
absenterais	absenter	Ver:CPre+SG+P1:CPre+SG+P2
absenterait	absenter	Ver:CPre+SG+P3
absenteras	absenter	Ver:IFut+SG+P2
absenterent	absenter	Ver:IPSim+PL+P3
absenterez	absenter	Ver:IFut+PL+P2
absenteriez	absenter	Ver:CPre+PL+P2
absenterions	absenter	Ver:CPre+PL+P1
absenterons	absenter	Ver:IFut+PL+P1
absenteront	absenter	Ver:IFut+PL+P3
absentes	absent	Adj:Fem+PL
absentes	absenter	Ver:IPre+SG+P2:SPre+SG+P2
absentes	absenter	Ver:PPas+Mas+PL
absentes	absent	Nom:Fem+PL
absentez	absenter	Ver:IPre+PL+P2:ImPre+PL+P2
absentiez	absenter	Ver:IImp+PL+P2:SPre+PL+P2
absentions	absenter	Ver:IImp+PL+P1:SPre+PL+P1
absentons	absenter	Ver:IPre+PL+P1:ImPre+PL+P1
absents	absent	Adj:Mas+PL
absidal	absidal	Adj:Mas+SG
absidale	absidal	Adj:Fem+SG
absidales	absidal	Adj:Fem+PL
absidaux	absidal	Adj:Mas+PL
abside	abside	Nom:Fem+SG
absidiole	absidiole	Nom:Fem+SG
absinthe	absinthe	Nom:Fem+SG
absinthe	absinther	Ver:IPre+SG+P1:IPre+SG+P3:SPre+SG+P1:SPre+SG+P3:ImPre+SG+P2
absinthisme	absinthisme	Nom:Mas+SG
absolu	absolu	Adj:Mas+SG
absolu	absolu	Nom:Mas+SG
absolue	absolu	Adj:Fem+SG
absolue	absolue	Nom:Fem+SG
absolues	absolu	Adj:Fem+PL
absolues	absolue	Nom:Fem+PL
absolument	absolument	Adv
absolus	absolu	Adj:Mas+PL
absolus	absoudre	Ver:IPSim+SG+P1:IPSim+SG+P2
absolution	absolution	Nom:Fem+SG
absolutions	absolution	Nom:Fem+PL
absolutisme	absolutisme	Nom:Mas+SG
absolutismes	absolutisme	Nom:Mas+PL
absolutiste	absolutiste	Adj:InvGen+SG
absolutoire	absolutoire	Adj:InvGen+SG
absolvaient	absoudre	Ver:IImp+PL+P3
absolvais	absoudre	Ver:IImp+SG+P1:IImp+SG+P2
absolvait	absoudre	Ver:IImp+SG+P3
absolvant	absoudre	Ver:PPre
absolve	absoudre	Ver:SPre+SG+P1:SPre+SG+P3
absolvent	absoudre	Ver:IPre+PL+P3:SPre+PL+P3
absolves	absoudre	Ver:SPre+SG+P2
absolvez	absoudre	Ver:IPre+PL+P2:ImPre+PL+P2
absolviez	absoudre	Ver:IImp+PL+P2:SPre+PL+P2
absolvions	absoudre	Ver:IImp+PL+P1:SPre+PL+P1
absolvons	absoudre	Ver:IPre+PL+P1:ImPre+PL+P1
absorba	absorber	Ver:IPSim+SG+P3
absorbai	absorber	Ver:IPSim+SG+P1
absorbaient	absorber	Ver:IImp+PL+P3
absorbais	absorber	Ver:IImp+SG+P1:IImp+SG+P2
absorbait	absorber	Ver:IImp+SG+P3
absorbames	absorber	Ver:IPSim+PL+P1
absorbant	absorbant	Adj:Mas+SG
absorbant	absorbant	Nom:Mas+SG
absorbant	absorber	Ver:PPre
absorbante	absorbant	Adj:Fem+SG
absorbantes	absorbant	Adj:Fem+PL
absorbants	absorbant	Adj:Mas+PL
absorbants	absorbant	Nom:Mas+PL
absorbas	absorber	Ver:IPSim+SG+P2
absorbasse	absorber	Ver:SImp+SG+P1
absorbassent	absorber	Ver:SImp+PL+P3
absorbasses	absorber	Ver:SImp+SG+P2
absorbassiez	absorber	Ver:SImp+PL+P2
absorbassions	absorber	Ver:SImp+PL+P1
absorbat	absorber	Ver:SImp+SG+P3
absorbates	absorber	Ver:IPSim+PL+P2
absorbe	absorbe	Adj:Mas+SG
absorbe	absorber	Ver:IPre+SG+P1:IPre+SG+P3:SPre+SG+P1:SPre+SG+P3:ImPre+SG+P2
absorbe	absorber	Ver:PPas+Mas+SG
absorbee	absorbe	Adj:Fem+SG
absorbee	absorber	Ver:PPas+Fem+SG
absorbees	absorbe	Adj:Fem+PL
absorbees	absorber	Ver:PPas+Fem+PL
absorbent	absorber	Ver:IPre+PL+P3
absorbent	absorber	Ver:SPre+PL+P3
absorbera	absorber	Ver:IFut+SG+P3
absorber	absorber	Ver:Inf
absorberai	absorber	Ver:IFut+SG+P1
absorberaient	absorber	Ver:CPre+PL+P3
absorberais	absorber	Ver:CPre+SG+P1:CPre+SG+P2
absorberait	absorber	Ver:CPre+SG+P3
absorberas	absorber	Ver:IFut+SG+P2
absorberent	absorber	Ver:IPSim+PL+P3
absorberez	absorber	Ver:IFut+PL+P2
absorberiez	absorber	Ver:CPre+PL+P2
absorberions	absorber	Ver:CPre+PL+P1
absorberons	absorber	Ver:IFut+PL+P1
absorberont	absorber	Ver:IFut+PL+P3
absorbes	absorbe	Adj:Mas+PL
absorbes	absorber	Ver:IPre+SG+P2:SPre+SG+P2
absorbes	absorber	Ver:PPas+Mas+PL
absorbeur	absorbeur	Nom:Mas+SG
absorbez	absorber	Ver:IPre+PL+P2:ImPre+PL+P2
absorbiez	absorber	Ver:IImp+PL+P2:SPre+PL+P2
absorbions	absorber	Ver:IImp+PL+P1:SPre+PL+P1
absorbons	absorber	Ver:IPre+PL+P1:ImPre+PL+P1
absorption	absorption	Nom:Fem+SG
absorptions	absorption	Nom:Fem+PL
absorptivite	absorptivite	Nom:Fem+SG
absorptivites	absorptivite	Nom:Fem+PL
absoudre	absoudre	Ver:Inf
absous	absoudre	Ver:PPas+Mas+SG:PPas+Mas+PL:IPre+SG+P1:IPre+SG+P2:ImPre+SG+P2
absout	absoudre	Ver:IPre+SG+P3
absoute	absoudre	Ver:PPas+Fem+SG
absoute	absoute	Nom:Fem+SG
absteme	absteme	Adj:InvGen+SG
absteme	absteme	Nom:InvGen+SG
abstenaient	abstenir	Ver:IImp+PL+P3
abstenais	abstenir	Ver:IImp+SG+P1:IImp+SG+P2
abstenait	abstenir	Ver:IImp+SG+P3
abstenant	abstenir	Ver:PPre
abstenez	abstenir	Ver:IPre+PL+P2:ImPre+PL+P2
absteniez	abstenir	Ver:IImp+PL+P2:SPre+PL+P2
abstenions	abstenir	Ver:IImp+PL+P1:SPre+PL+P1
abstenir	abstenir	Ver:Inf
abstenons	abstenir	Ver:IPre+PL+P1:ImPre+PL+P1
abstention	abstention	Nom:Fem+SG
abstentionnisme	abstentionnisme	Nom:Mas+SG
abstentionniste	abstentionniste	Adj:InvGen+SG
abstentionniste	abstentionniste	Nom:InvGen+SG
abstentionnistes	abstentionniste	Adj:InvGen+PL
abstentionnistes	abstentionniste	Nom:InvGen+PL
abstentions	abstention	Nom:Fem+PL
abstenu	abstenir	Ver:PPas+Mas+SG
abstenue	abstenir	Ver:PPas+Fem+SG
abstenues	abstenir	Ver:PPas+Fem+PL
abstenus	abstenir	Ver:PPas+Mas+PL
abstergeant	absterger	Ver:PPre
abstergeant	absterger	Ver:PPre+Mas+SG
abstergent	absterger	Ver:IPre+PL+P3
abstergent	absterger	Ver:SPre+PL+P3
abstiendra	abstenir	Ver:IFut+SG+P3
abstiendrai	abstenir	Ver:IFut+SG+P1
abstiendraient	abstenir	Ver:CPre+PL+P3
abstiendrais	abstenir	Ver:CPre+SG+P1:CPre+SG+P2
abstiendrait	abstenir	Ver:CPre+SG+P3
abstiendras	abstenir	Ver:IFut+SG+P2
abstiendrez	abstenir	Ver:IFut+PL+P2
abstiendriez	abstenir	Ver:CPre+PL+P2
abstiendrions	abstenir	Ver:CPre+PL+P1
abstiendrons	abstenir	Ver:IFut+PL+P1
abstiendront	abstenir	Ver:IFut+PL+P3
abstienne	abstenir	Ver:SPre+SG+P1:SPre+SG+P3
abstiennent	abstenir	Ver:IPre+PL+P3:SPre+PL+P3
abstiennes	abstenir	Ver:SPre+SG+P2
abstiens	abstenir	Ver:IPre+SG+P1:IPre+SG+P2:ImPre+SG+P2
abstient	abstenir	Ver:IPre+SG+P3
abstinence	abstinence	Nom:Fem+SG
abstinent	abstinent	Adj:Mas+SG
abstinent	abstinent	Nom:Mas+SG
abstinente	abstinent	Adj:Fem+SG
abstinente	abstinent	Nom:Fem+SG
abstinentes	abstinent	Adj:Fem+PL
abstinentes	abstinent	Nom:Fem+PL
abstinents	abstinent	Adj:Mas+PL
abstinents	abstinent	Nom:Mas+PL
abstinmes	abstenir	Ver:IPSim+PL+P1
abstinrent	abstenir	Ver:IPSim+PL+P3
abstins	abstenir	Ver:IPSim+SG+P1:IPSim+SG+P2
abstinsse	abstenir	Ver:SImp+SG+P1
abstinssent	abstenir	Ver:SImp+PL+P3
abstinsses	abstenir	Ver:SImp+SG+P2
abstinssiez	abstenir	Ver:SImp+PL+P2
abstinssions	abstenir	Ver:SImp+PL+P1
abstint	abstenir	Ver:IPSim+SG+P3
abstint	abstenir	Ver:SImp+SG+P3
abstintes	abstenir	Ver:IPSim+PL+P2
abstracteur	abstracteur	Adj:Mas+SG
abstraction	abstraction	Nom:Fem+SG
abstractionnisme	abstractionnisme	Nom:Mas+SG
abstractions	abstraction	Nom:Fem+PL
abstraie	abstraire	Ver:SPre+SG+P1:SPre+SG+P3
abstraient	abstraire	Ver:IPre+PL+P3:SPre+PL+P3
abstraies	abstraire	Ver:SPre+SG+P2
abstraira	abstraire	Ver:IFut+SG+P3
abstrairai	abstraire	Ver:IFut+SG+P1
abstrairaient	abstraire	Ver:CPre+PL+P3
abstrairais	abstraire	Ver:CPre+SG+P1:CPre+SG+P2
abstrairait	abstraire	Ver:CPre+SG+P3
abstrairas	abstraire	Ver:IFut+SG+P2
abstraire	abstraire	Ver:Inf
abstrairez	abstraire	Ver:IFut+PL+P2
abstrairiez	abstraire	Ver:CPre+PL+P2
abstrairions	abstraire	Ver:CPre+PL+P1
abstrairons	abstraire	Ver:IFut+PL+P1
abstrairont	abstraire	Ver:IFut+PL+P3
abstrais	abstraire	Ver:IPre+SG+P1:IPre+SG+P2:ImPre+SG+P2
abstrait	abstraire	Ver:PPas+Mas+SG:IPre+SG+P3
abstrait	abstrait	Adj:Mas+SG
abstrait	abstrait	Nom:Mas+SG
abstraite	abstraire	Ver:PPas+Fem+SG
abstraite	abstrait	Adj:Fem+SG
abstraitement	abstraitement	Adv
abstraites	abstraire	Ver:PPas+Fem+PL
abstraites	abstrait	Adj:Fem+PL
abstraits	abstraire	Ver:PPas+Mas+PL
abstraits	abstrait	Adj:Mas+PL
abstraits	abstrait	Nom:Mas+PL
abstrayaient	abstraire	Ver:IImp+PL+P3
abstrayais	abstraire	Ver:IImp+SG+P1
abstrayais	abstraire	Ver:IImp+SG+P2
abstrayait	abstraire	Ver:IImp+SG+P3
abstrayant	abstraire	Ver:PPre
abstrayant	abstraire	Ver:PPre+Mas+SG
abstrayez	abstraire	Ver:Imp+PL+P2
abstrayez	abstraire	Ver:IPre+PL+P2
abstrayiez	abstraire	Ver:IImp+PL+P2
abstrayiez	abstraire	Ver:SPre+PL+P2
abstrayions	abstraire	Ver:IImp+PL+P1:SPre+PL+P1
abstrayons	abstraire	Ver:IPre+PL+P1:ImPre+PL+P1
abstrus	abstrus	Adj:Mas+InvPL
abstruse	abstrus	Adj:Fem+SG
abstruses	abstrus	Adj:Fem+PL
absurde	absurde	Adj:InvGen+SG
absurde	absurde	Nom:Mas+SG
absurdes	absurde	Adj:InvGen+PL
absurdite	absurdite	Nom:Fem+SG
absurdites	absurdite	Nom:Fem+PL
abusa	abuser	Ver:IPSim+SG+P3
abu	abu	Nom:Mas+InvPL
abus	abus	Nom:Mas+InvPL
abusai	abuser	Ver:IPSim+SG+P1
abusaient	abuser	Ver:IImp+PL+P3
abusais	abuser	Ver:IImp+SG+P1:IImp+SG+P2
abusait	abuser	Ver:IImp+SG+P3
abusames	abuser	Ver:IPSim+PL+P1
abusant	abuser	Ver:PPre
abusas	abuser	Ver:IPSim+SG+P2
abusasse	abuser	Ver:SImp+SG+P1
abusassent	abuser	Ver:SImp+PL+P3
abusasses	abuser	Ver:SImp+SG+P2
abusassiez	abuser	Ver:SImp+PL+P2
abusassions	abuser	Ver:SImp+PL+P1
abusat	abuser	Ver:SImp+SG+P3
abusates	abuser	Ver:IPSim+PL+P2
abuse	abuser	Ver:IPre+SG+P1:IPre+SG+P3:SPre+SG+P1:SPre+SG+P3:ImPre+SG+P2
abuse	abuser	Ver:PPas+Mas+SG
abusee	abuser	Ver:PPas+Fem+SG
abusees	abuser	Ver:PPas+Fem+PL
abusent	abuser	Ver:IPre+PL+P3:SPre+PL+P3
abusera	abuser	Ver:IFut+SG+P3
abuser	abuser	Ver:Inf
abuserai	abuser	Ver:IFut+SG+P1
abuseraient	abuser	Ver:CPre+PL+P3
abuserais	abuser	Ver:CPre+SG+P1:CPre+SG+P2
abuserait	abuser	Ver:CPre+SG+P3
abuseras	abuser	Ver:IFut+SG+P2
abuserent	abuser	Ver:IPSim+PL+P3
abuserez	abuser	Ver:IFut+PL+P2
abuseriez	abuser	Ver:CPre+PL+P2
abuserions	abuser	Ver:CPre+PL+P1
abuserons	abuser	Ver:IFut+PL+P1
abuseront	abuser	Ver:IFut+PL+P3
abuses	abuser	Ver:IPre+SG+P2:SPre+SG+P2
abuses	abuser	Ver:PPas+Mas+PL
abusez	abuser	Ver:IPre+PL+P2:ImPre+PL+P2
abusiez	abuser	Ver:IImp+PL+P2:SPre+PL+P2
abusif	abusif	Adj:Mas+SG
abusifs	abusif	Adj:Mas+PL
abusions	abuser	Ver:IImp+PL+P1:SPre+PL+P1
abusive	abusif	Adj:Fem+SG
abusivement	abusivement	Adv
abusives	abusif	Adj:Fem+PL
abusons	abuser	Ver:IPre+PL+P1:ImPre+PL+P1
abyssal	abyssal	Adj:Mas+SG
abyssale	abyssal	Adj:Fem+SG
abyssales	abyssal	Adj:Fem+PL
abyssaux	abyssal	Adj:Mas+PL
abysse	abysse	Nom:Mas+SG
abysses	abysse	Nom:Mas+PL
abyssin	abyssin	Adj:Mas+SG
abyssin	abyssin	Nom:Mas+SG
abyssine	abyssin	Adj:Fem+SG
abyssine	abyssin	Nom:Fem+SG
abyssines	abyssin	Adj:Fem+PL
abyssines	abyssin	Nom:Fem+PL
abyssinien	abyssinien	Adj:Mas+SG
abyssinienne	abyssinien	Adj:Fem+SG
abyssinienne	abyssinien	Nom:Fem+SG
abyssiniennes	abyssinien	Adj:Fem+PL
abyssiniennes	abyssinien	Nom:Fem+PL
abyssins	abyssin	Adj:Mas+PL
abyssins	abyssin	Nom:Mas+PL
acabit	acabit	Nom:Mas+SG
acabits	acabit	Nom:Mas+PL
ac	acer	Ver:IImp+SG+P1:IImp+SG+P2
acacia	acacia	Nom:Mas+SG
acacias	acacia	Nom:Mas+PL
ac	acire	Ver:IImp+SG+P1:IImp+SG+P2
academicien	academicien	Nom:Mas+SG
academicienne	academicien	Nom:Fem+SG
academiciennes	academicien	Nom:Fem+PL
academiciens	academicien	Nom:Mas+PL
academie	academie	Nom:Fem+SG
academies	academie	Nom:Fem+PL
academique	academique	Adj:InvGen+SG
academiquement	academiquement	Adv
academiques	academique	Adj:InvGen+PL
academisme	academisme	Nom:Mas+SG
academismes	academisme	Nom:Mas+PL
acadien	acadien	Adj:Mas+SG
acagnardant	acagnarder	Ver:PPre
acagnardant	acagnarder	Ver:PPre+Mas+SG
acagnarde	acagnarder	Ver:Imp+SG+P2
acagnarde	acagnarder	Ver:IPre+SG+P1
acagnarde	acagnarder	Ver:IPre+SG+P3
acagnarde	acagnarder	Ver:SPre+SG+P1
acagnarde	acagnarder	Ver:SPre+SG+P3
acagnarder	acagnarder	Ver:Inf
acajou	acajou	Adj:InvGen+SG:InvGen+PL
acajou	acajou	Nom:Mas+SG
acajous	acajou	Nom:Mas+PL
acalephes	acalephe	Nom:Mas+PL
acanthacees	acanthacee	Nom:Fem+PL
acanthe	acanthe	Nom:Fem+SG
acanthocephale	acanthocephale	Nom:Mas+SG
acanthopterygiens	acanthopterygien	Nom:Mas+PL
acariatre	acariatre	Adj:InvGen+SG
acariatres	acariatre	Adj:InvGen+PL
acariatrete	acariatrete	Nom:Fem+SG
acariens	acarien	Nom:Mas+PL
acarus	acarus	Nom:Mas+InvPL
acaule	acaule	Adj:InvGen+SG
accabla	accabler	Ver:IPSim+SG+P3
accablai	accabler	Ver:IPSim+SG+P1
accablaient	accabler	Ver:IImp+PL+P3
accablais	accabler	Ver:IImp+SG+P1:IImp+SG+P2
accablait	accabler	Ver:IImp+SG+P3
accablames	accabler	Ver:IPSim+PL+P1
accablant	accablant	Adj:Mas+SG
accablant	accabler	Ver:PPre
accablante	accablant	Adj:Fem+SG
accablantes	accablant	Adj:Fem+PL
accablants	accablant	Adj:Mas+PL
accablas	accabler	Ver:IPSim+SG+P2
accablasse	accabler	Ver:SImp+SG+P1
accablassent	accabler	Ver:SImp+PL+P3
accablasses	accabler	Ver:SImp+SG+P2
accablassiez	accabler	Ver:SImp+PL+P2
accablassions	accabler	Ver:SImp+PL+P1
accablat	accabler	Ver:SImp+SG+P3
accablates	accabler	Ver:IPSim+PL+P2
accable	accable	Adj:Mas+SG
accable	accabler	Ver:IPre+SG+P1:IPre+SG+P3:SPre+SG+P1:SPre+SG+P3:ImPre+SG+P2
accable	accabler	Ver:PPas+Mas+SG
accablee	accable	Adj:Fem+SG
accablee	accabler	Ver:PPas+Fem+SG
accablees	accable	Adj:Fem+PL
accablees	accabler	Ver:PPas+Fem+PL
accablement	accablement	Nom:Mas+SG
accablements	accablement	Nom:Mas+PL
accablent	accabler	Ver:IPre+PL+P3:SPre+PL+P3
accablera	accabler	Ver:IFut+SG+P3
accabler	accabler	Ver:Inf
accablerai	accabler	Ver:IFut+SG+P1
accableraient	accabler	Ver:CPre+PL+P3
accablerais	accabler	Ver:CPre+SG+P1:CPre+SG+P2
accablerait	accabler	Ver:CPre+SG+P3
accableras	accabler	Ver:IFut+SG+P2
accablerent	accabler	Ver:IPSim+PL+P3
accablerez	accabler	Ver:IFut+PL+P2
accableriez	accabler	Ver:CPre+PL+P2
accablerions	accabler	Ver:CPre+PL+P1
accablerons	accabler	Ver:IFut+PL+P1
accableront	accabler	Ver:IFut+PL+P3
accables	accable	Adj:Mas+PL
accables	accabler	Ver:IPre+SG+P2:SPre+SG+P2
accables	accabler	Ver:PPas+Mas+PL
accablez	accabler	Ver:IPre+PL+P2:ImPre+PL+P2
accabliez	accabler	Ver:IImp+PL+P2:SPre+PL+P2
accablions	accabler	Ver:IImp+PL+P1:SPre+PL+P1
accablons	accabler	Ver:IPre+PL+P1:ImPre+PL+P1
accalmie	accalmie	Nom:Fem+SG
accalmie	accalmir	Ver:PPas+Fem+SG
accalmies	accalmie	Nom:Fem+PL
accalmies	accalmir	Ver:PPas+Fem+PL
accapara	accaparer	Ver:IPSim+SG+P3
accaparai	accaparer	Ver:IPSim+SG+P1
accaparaient	accaparer	Ver:IImp+PL+P3
accaparais	accaparer	Ver:IImp+SG+P1:IImp+SG+P2
accaparait	accaparer	Ver:IImp+SG+P3
accaparames	accaparer	Ver:IPSim+PL+P1
accaparant	accaparant	Adj:Mas+SG
accaparante	accaparant	Adj:Fem+SG
accaparantes	accaparant	Adj:Fem+PL
accaparants	accaparant	Adj:Mas+PL
accaparas	accaparer	Ver:IPSim+SG+P2
accaparasse	accaparer	Ver:SImp+SG+P1
accaparassent	accaparer	Ver:SImp+PL+P3
accaparasses	accaparer	Ver:SImp+SG+P2
accaparassiez	accaparer	Ver:SImp+PL+P2
accaparassions	accaparer	Ver:SImp+PL+P1
accaparat	accaparer	Ver:SImp+SG+P3
accaparates	accaparer	Ver:IPSim+PL+P2
accapare	accaparer	Ver:IPre+SG+P1:IPre+SG+P3:SPre+SG+P1:SPre+SG+P3:ImPre+SG+P2
accapare	accaparer	Ver:PPas+Mas+SG
accaparee	accaparer	Ver:PPas+Fem+SG
accaparees	accaparer	Ver:PPas+Fem+PL
accaparement	accaparement	Nom:Mas+SG
accaparent	accaparer	Ver:IPre+PL+P3:SPre+PL+P3
accaparera	accaparer	Ver:IFut+SG+P3
accaparer	accaparer	Ver:Inf
accaparerai	accaparer	Ver:IFut+SG+P1
accapareraient	accaparer	Ver:CPre+PL+P3
accaparerais	accaparer	Ver:CPre+SG+P1:CPre+SG+P2
accaparerait	accaparer	Ver:CPre+SG+P3
accapareras	accaparer	Ver:IFut+SG+P2
accaparerent	accaparer	Ver:IPSim+PL+P3
accaparerez	accaparer	Ver:IFut+PL+P2
accapareriez	accaparer	Ver:CPre+PL+P2
accaparerions	accaparer	Ver:CPre+PL+P1
accaparerons	accaparer	Ver:IFut+PL+P1
accapareront	accaparer	Ver:IFut+PL+P3
accapares	accaparer	Ver:IPre+SG+P2:SPre+SG+P2
accapares	accaparer	Ver:PPas+Mas+PL
accapareur	accapareur	Adj:Mas+SG
accapareur	accapareur	Nom:Mas+SG
accapareurs	accapareur	Adj:Mas+PL
accapareurs	accapareur	Nom:Mas+PL
accapareuse	accapareur	Nom:Fem+SG
accaparez	accaparer	Ver:IPre+PL+P2:ImPre+PL+P2
accapariez	accaparer	Ver:IImp+PL+P2:SPre+PL+P2
accaparions	accaparer	Ver:IImp+PL+P1:SPre+PL+P1
accaparons	accaparer	Ver:IPre+PL+P1:ImPre+PL+P1
accastiller	accastiller	Ver:Inf
acceda	acceder	Ver:IPSim+SG+P3
accedai	acceder	Ver:IPSim+SG+P1
accedaient	acceder	Ver:IImp+PL+P3
accedais	acceder	Ver:IImp+SG+P1:IImp+SG+P2
accedait	acceder	Ver:IImp+SG+P3
accedames	acceder	Ver:IPSim+PL+P1
accedant	accedant	Nom:Mas+SG
accedant	acceder	Ver:PPre
accedas	acceder	Ver:IPSim+SG+P2
accedasse	acceder	Ver:SImp+SG+P1
accedassent	acceder	Ver:SImp+PL+P3
accedasses	acceder	Ver:SImp+SG+P2
accedassiez	acceder	Ver:SImp+PL+P2
accedassions	acceder	Ver:SImp+PL+P1
accedat	acceder	Ver:SImp+SG+P3
accedates	acceder	Ver:IPSim+PL+P2
accede	acceder	Ver:IPre+SG+P1:IPre+SG+P3:SPre+SG+P1:SPre+SG+P3:ImPre+SG+P2
accede	acceder	Ver:PPas+Mas+SG
accedees	acceder	Ver:PPas+Fem+PL
accedent	acceder	Ver:IPre+PL+P3:SPre+PL+P3
accedera	acceder	Ver:IFut+SG+P3
acceder	acceder	Ver:Inf
accederai	acceder	Ver:IFut+SG+P1
accederaient	acceder	Ver:CPre+PL+P3
accederais	acceder	Ver:CPre+SG+P1:CPre+SG+P2
accederait	acceder	Ver:CPre+SG+P3
accederas	acceder	Ver:IFut+SG+P2
accederent	acceder	Ver:IPSim+PL+P3
accederez	acceder	Ver:IFut+PL+P2
accederiez	acceder	Ver:CPre+PL+P2
accederions	acceder	Ver:CPre+PL+P1
accederons	acceder	Ver:IFut+PL+P1
accederont	acceder	Ver:IFut+PL+P3
accedes	acceder	Ver:IPre+SG+P2:SPre+SG+P2
accedez	acceder	Ver:Imp+PL+P2
accedez	acceder	Ver:IPre+PL+P2
accediez	acceder	Ver:IImp+PL+P2:SPre+PL+P2
accedions	acceder	Ver:IImp+PL+P1:SPre+PL+P1
accedons	acceder	Ver:Imp+PL+P1
accedons	acceder	Ver:IPre+PL+P1
accelera	accelerer	Ver:IPSim+SG+P3
accelerai	accelerer	Ver:IPSim+SG+P1
acceleraient	accelerer	Ver:IImp+PL+P3
accelerais	accelerer	Ver:IImp+SG+P1:IImp+SG+P2
accelerait	accelerer	Ver:IImp+SG+P3
accelerames	accelerer	Ver:IPSim+PL+P1
accelerando	accelerando	Adv
accelerant	accelerer	Ver:PPre
acceleras	accelerer	Ver:IPSim+SG+P2
accelerasse	accelerer	Ver:SImp+SG+P1
accelerassent	accelerer	Ver:SImp+PL+P3
accelerasses	accelerer	Ver:SImp+SG+P2
accelerassiez	accelerer	Ver:SImp+PL+P2
accelerassions	accelerer	Ver:SImp+PL+P1
accelerat	accelerer	Ver:SImp+SG+P3
accelerates	accelerer	Ver:IPSim+PL+P2
accelerateur	accelerateur	Adj:Mas+SG
accelerateur	accelerateur	Nom:Mas+SG
accelerateurs	accelerateur	Adj:Mas+PL
accelerateurs	accelerateur	Nom:Mas+PL
acceleration	acceleration	Nom:Fem+SG
accelerations	acceleration	Nom:Fem+PL
acceleratrice	accelerateur	Adj:Fem+SG
acceleratrices	accelerateur	Adj:Fem+PL
accelere	accelere	Adj:Mas+SG
accelere	accelere	Nom:Mas+SG
accelere	accelerer	Ver:IPre+SG+P1:IPre+SG+P3:SPre+SG+P1:SPre+SG+P3:ImPre+SG+P2
accelere	accelerer	Ver:PPas+Mas+SG
acceleree	accelere	Adj:Fem+SG
acceleree	accelerer	Ver:PPas+Fem+SG
accelerees	accelere	Adj:Fem+PL
accelerees	accelerer	Ver:PPas+Fem+PL
accelerent	accelerer	Ver:IPre+PL+P3:SPre+PL+P3
accelerera	accelerer	Ver:IFut+SG+P3
accelerer	accelerer	Ver:Inf
accelererai	accelerer	Ver:IFut+SG+P1
accelereraient	accelerer	Ver:CPre+PL+P3
accelererais	accelerer	Ver:CPre+SG+P1:CPre+SG+P2
accelererait	accelerer	Ver:CPre+SG+P3
accelereras	accelerer	Ver:IFut+SG+P2
accelererent	accelerer	Ver:IPSim+PL+P3
accelererez	accelerer	Ver:IFut+PL+P2
accelereriez	accelerer	Ver:CPre+PL+P2
accelererions	accelerer	Ver:CPre+PL+P1
accelererons	accelerer	Ver:IFut+PL+P1
accelereront	accelerer	Ver:IFut+PL+P3
acceleres	accelere	Adj:Mas+PL
acceleres	accelere	Nom:Mas+PL
acceleres	accelerer	Ver:IPre+SG+P2:SPre+SG+P2
acceleres	accelerer	Ver:PPas+Mas+PL
accelerez	accelerer	Ver:IPre+PL+P2:ImPre+PL+P2
acceleriez	accelerer	Ver:IImp+PL+P2:SPre+PL+P2
accelerions	accelerer	Ver:IImp+PL+P1:SPre+PL+P1
accelerographe	accelerographe	Nom:Mas+SG
accelerometre	accelerometre	Nom:Mas+SG
accelerons	accelerer	Ver:IPre+PL+P1:ImPre+PL+P1
accent	accent	Nom:Mas+SG
accents	accent	Nom:Mas+PL
accentua	accentuer	Ver:IPSim+SG+P3
accentuai	accentuer	Ver:IPSim+SG+P1
accentuaient	accentuer	Ver:IImp+PL+P3
accentuais	accentuer	Ver:IImp+SG+P1
accentuais	accentuer	Ver:IImp+SG+P2
accentuait	accentuer	Ver:IImp+SG+P3
accentuames	accentuer	Ver:IPSim+PL+P1
accentuant	accentuer	Ver:PPre
accentuas	accentuer	Ver:IPSim+SG+P2
accentuasse	accentuer	Ver:SImp+SG+P1
accentuassent	accentuer	Ver:SImp+PL+P3
accentuasses	accentuer	Ver:SImp+SG+P2
accentuassiez	accentuer	Ver:SImp+PL+P2
accentuassions	accentuer	Ver:SImp+PL+P1
accentuat	accentuer	Ver:SImp+SG+P3
accentuates	accentuer	Ver:IPSim+PL+P2
accentuation	accentuation	Nom:Fem+SG
accentuations	accentuation	Nom:Fem+PL
accentue	accentue	Adj:Mas+SG
accentue	accentuer	Ver:IPre+SG+P1:IPre+SG+P3:SPre+SG+P1:SPre+SG+P3:ImPre+SG+P2
accentue	accentuer	Ver:PPas+Mas+SG
accentuee	accentue	Adj:Fem+SG
accentuees	accentue	Adj:Fem+PL
accentuel	accentuel	Adj:Mas+SG
accentuelle	accentuel	Adj:Fem+SG
accentuelles	accentuel	Adj:Fem+PL
accentuent	accentuer	Ver:IPre+PL+P3:SPre+PL+P3
accentuera	accentuer	Ver:IFut+SG+P3
accentuer	accentuer	Ver:Inf
accentuerai	accentuer	Ver:IFut+SG+P1
accentueraient	accentuer	Ver:CPre+PL+P3
accentuerais	accentuer	Ver:CPre+SG+P1:CPre+SG+P2
accentuerait	accentuer	Ver:CPre+SG+P3
accentueras	accentuer	Ver:IFut+SG+P2
accentuerent	accentuer	Ver:IPSim+PL+P3
accentuerez	accentuer	Ver:IFut+PL+P2
accentueriez	accentuer	Ver:CPre+PL+P2
accentuerions	accentuer	Ver:CPre+PL+P1
accentuerons	accentuer	Ver:IFut+PL+P1
accentueront	accentuer	Ver:IFut+PL+P3
accentues	accentue	Adj:Mas+PL
accentues	accentuer	Ver:IPre+SG+P2:SPre+SG+P2
accentues	accentuer	Ver:PPas+Mas+PL
accentuez	accentuer	Ver:IPre+PL+P2:ImPre+PL+P2
accentuiez	accentuer	Ver:IImp+PL+P2:SPre+PL+P2
accentuions	accentuer	Ver:IImp+PL+P1
accentuions	accentuer	Ver:SPre+PL+P1
accentuons	accentuer	Ver:IPre+PL+P1:ImPre+PL+P1
accepta	accepter	Ver:IPSim+SG+P3
acceptabilite	acceptabilite	Nom:Fem+SG
acceptable	acceptable	Adj:InvGen+SG
acceptables	acceptable	Adj:InvGen+PL
acceptai	accepter	Ver:IPSim+SG+P1
acceptaient	accepter	Ver:IImp+PL+P3
acceptais	accepter	Ver:IImp+SG+P1:IImp+SG+P2
acceptait	accepter	Ver:IImp+SG+P3
acceptames	accepter	Ver:IPSim+PL+P1
acceptant	acceptant	Adj:Mas+SG
acceptant	acceptant	Nom:Mas+SG
acceptant	accepter	Ver:PPre
acceptante	acceptant	Adj:Fem+SG
acceptante	acceptant	Nom:Fem+SG
acceptantes	acceptant	Adj:Fem+PL
acceptantes	acceptant	Nom:Fem+PL
acceptas	accepter	Ver:IPSim+SG+P2
acceptasse	accepter	Ver:SImp+SG+P1
acceptassent	accepter	Ver:SImp+PL+P3
acceptasses	accepter	Ver:SImp+SG+P2
acceptassiez	accepter	Ver:SImp+PL+P2
acceptassions	accepter	Ver:SImp+PL+P1
acceptat	accepter	Ver:SImp+SG+P3
acceptates	accepter	Ver:IPSim+PL+P2
acceptation	acceptation	Nom:Fem+SG
acceptations	acceptation	Nom:Fem+PL
accepte	accepte	Adj:Mas+SG
accepte	accepter	Ver:IPre+SG+P1:IPre+SG+P3:SPre+SG+P1:SPre+SG+P3:ImPre+SG+P2
acceptee	accepte	Adj:Fem+SG
acceptee	accepter	Ver:PPas+Fem+SG
acceptees	accepte	Adj:Fem+PL
acceptees	accepter	Ver:PPas+Fem+PL
acceptent	accepter	Ver:IPre+PL+P3:SPre+PL+P3
acceptera	accepter	Ver:IFut+SG+P3
accepter	accepter	Ver:Inf
accepterai	accepter	Ver:IFut+SG+P1
accepteraient	accepter	Ver:CPre+PL+P3
accepterais	accepter	Ver:CPre+SG+P1:CPre+SG+P2
accepterait	accepter	Ver:CPre+SG+P3
accepteras	accepter	Ver:IFut+SG+P2
accepterent	accepter	Ver:IPSim+PL+P3
accepterez	accepter	Ver:IFut+PL+P2
accepteriez	accepter	Ver:CPre+PL+P2
accepterions	accepter	Ver:CPre+PL+P1
accepterons	accepter	Ver:IFut+PL+P1
accepteront	accepter	Ver:IFut+PL+P3
acceptes	accepte	Adj:Mas+PL
acceptes	accepter	Ver:IPre+SG+P2:SPre+SG+P2
acceptes	accepter	Ver:PPas+Mas+PL
accepteur	accepteur	Adj:Mas+SG
accepteur	accepteur	Nom:Mas+SG
accepteurs	accepteur	Adj:Mas+PL
accepteurs	accepteur	Nom:Mas+PL
acceptez	accepter	Ver:IPre+PL+P2:ImPre+PL+P2
acceptiez	accepter	Ver:IImp+PL+P2:SPre+PL+P2
acception	acception	Nom:Fem+SG
acceptions	accepter	Ver:IImp+PL+P1:SPre+PL+P1
acceptions	acception	Nom:Fem+PL
acceptons	accepter	Ver:IPre+PL+P1:ImPre+PL+P1
acces	acces	Nom:Mas+InvPL
accessibilite	accessibilite	Nom:Fem+SG
accessibilites	accessibilite	Nom:Fem+PL
accessible	accessible	Adj:InvGen+SG
accessibles	accessible	Adj:InvGen+PL
accession	accession	Nom:Fem+SG
accessions	accession	Nom:Fem+PL
accessit	accessit	Nom:Mas+SG
accessits	accessit	Nom:Mas+PL
accessoire	accessoire	Adj:InvGen+SG
accessoire	accessoire	Nom:Mas+SG
accessoirement	accessoirement	Adv
accessoires	accessoire	Adj:InvGen+PL
accessoires	accessoire	Nom:Mas+PL
accessoiriser	accessoiriser	Ver:Inf
accessoiriste	accessoiriste	Nom:InvGen+SG
accessoiristes	accessoiriste	Nom:InvGen+PL
accident	accident	Nom:Mas+SG
accidentant	accidenter	Ver:PPre
accidentant	accidenter	Ver:PPre+Mas+SG
accidente	accidente	Adj:Mas+SG
accidente	accidenter	Ver:Imp+SG+P2
accidente	accidenter	Ver:IPre+SG+P1
accidente	accidenter	Ver:IPre+SG+P3
accidente	accidenter	Ver:PPas
accidente	accidenter	Ver:PPas+Mas+SG
accidente	accidenter	Ver:SPre+SG+P1
accidente	accidenter	Ver:SPre+SG+P3
accidentee	accidente	Adj:Fem+SG
accidentee	accidenter	Ver:PPas+Fem+SG
accidentees	accidente	Adj:Fem+PL
accidentees	accidenter	Ver:PPas+Fem+PL
accidentel	accidentel	Adj:Mas+SG
accidentelle	accidentel	Adj:Fem+SG
accidentellement	accidentellement	Adv
accidentelles	accidentel	Adj:Fem+PL
accidentels	accidentel	Adj:Mas+PL
accidenter	accidenter	Ver:Inf
accidentes	accidente	Adj:Mas+PL
accidentes	accidenter	Ver:IPre+SG+P2
accidentes	accidenter	Ver:PPas+Mas+PL
accidentes	accidenter	Ver:SPre+SG+P2
accidents	accident	Nom:Mas+PL
accise	accise	Nom:Fem+SG
acclama	acclamer	Ver:IPSim+SG+P3
acclamai	acclamer	Ver:IPSim+SG+P1
acclamaient	acclamer	Ver:IImp+PL+P3
acclamais	acclamer	Ver:IImp+SG+P1:IImp+SG+P2
acclamait	acclamer	Ver:IImp+SG+P3
acclamames	acclamer	Ver:IPSim+PL+P1
acclamant	acclamer	Ver:PPre
acclamas	acclamer	Ver:IPSim+SG+P2
acclamasse	acclamer	Ver:SImp+SG+P1
acclamassent	acclamer	Ver:SImp+PL+P3
acclamasses	acclamer	Ver:SImp+SG+P2
acclamassiez	acclamer	Ver:SImp+PL+P2
acclamassions	acclamer	Ver:SImp+PL+P1
acclamat	acclamer	Ver:SImp+SG+P3
acclamates	acclamer	Ver:IPSim+PL+P2
acclamation	acclamation	Nom:Fem+SG
acclamations	acclamation	Nom:Fem+PL
acclame	acclamer	Ver:IPre+SG+P1:IPre+SG+P3:SPre+SG+P1:SPre+SG+P3:ImPre+SG+P2
acclame	acclamer	Ver:PPas+Mas+SG
acclamee	acclamer	Ver:PPas+Fem+SG
acclamees	acclamer	Ver:PPas+Fem+PL
acclament	acclamer	Ver:IPre+PL+P3:SPre+PL+P3
acclamera	acclamer	Ver:IFut+SG+P3
acclamer	acclamer	Ver:Inf
acclamerai	acclamer	Ver:IFut+SG+P1
acclameraient	acclamer	Ver:CPre+PL+P3
acclamerais	acclamer	Ver:CPre+SG+P1:CPre+SG+P2
acclamerait	acclamer	Ver:CPre+SG+P3
acclameras	acclamer	Ver:IFut+SG+P2
acclamerent	acclamer	Ver:IPSim+PL+P3
acclamerez	acclamer	Ver:IFut+PL+P2
acclameriez	acclamer	Ver:CPre+PL+P2
acclamerions	acclamer	Ver:CPre+PL+P1
acclamerons	acclamer	Ver:IFut+PL+P1
acclameront	acclamer	Ver:IFut+PL+P3
acclames	acclamer	Ver:IPre+SG+P2:SPre+SG+P2
acclames	acclamer	Ver:PPas+Mas+PL
acclamez	acclamer	Ver:IPre+PL+P2:ImPre+PL+P2
acclamiez	acclamer	Ver:IImp+PL+P2:SPre+PL+P2
acclamions	acclamer	Ver:IImp+PL+P1:SPre+PL+P1
acclamons	acclamer	Ver:IPre+PL+P1:ImPre+PL+P1
acclimata	acclimater	Ver:IPSim+SG+P3
acclimatable	acclimatable	Adj:InvGen+SG
acclimatai	acclimater	Ver:IPSim+SG+P1
acclimataient	acclimater	Ver:IImp+PL+P3
acclimatais	acclimater	Ver:IImp+SG+P1:IImp+SG+P2
acclimatait	acclimater	Ver:IImp+SG+P3
acclimatames	acclimater	Ver:IPSim+PL+P1
acclimatant	acclimater	Ver:PPre
acclimatas	acclimater	Ver:IPSim+SG+P2
acclimatasse	acclimater	Ver:SImp+SG+P1
acclimatassent	acclimater	Ver:SImp+PL+P3
acclimatasses	acclimater	Ver:SImp+SG+P2
acclimatassiez	acclimater	Ver:SImp+PL+P2
acclimatassions	acclimater	Ver:SImp+PL+P1
acclimatat	acclimater	Ver:SImp+SG+P3
acclimatates	acclimater	Ver:IPSim+PL+P2
acclimatation	acclimatation	Nom:Fem+SG
acclimatations	acclimatation	Nom:Fem+PL
acclimate	acclimater	Ver:IPre+SG+P1:IPre+SG+P3:SPre+SG+P1:SPre+SG+P3:ImPre+SG+P2
acclimate	acclimater	Ver:PPas+Mas+SG
acclimatee	acclimater	Ver:PPas+Fem+SG
acclimatees	acclimater	Ver:PPas+Fem+PL
acclimatement	acclimatement	Nom:Mas+SG
acclimatent	acclimater	Ver:IPre+PL+P3:SPre+PL+P3
acclimatera	acclimater	Ver:IFut+SG+P3
acclimater	acclimater	Ver:Inf
acclimaterai	acclimater	Ver:IFut+SG+P1
acclimateraient	acclimater	Ver:CPre+PL+P3
acclimaterais	acclimater	Ver:CPre+SG+P1:CPre+SG+P2
acclimaterait	acclimater	Ver:CPre+SG+P3
acclimateras	acclimater	Ver:IFut+SG+P2
acclimaterent	acclimater	Ver:IPSim+PL+P3
acclimaterez	acclimater	Ver:IFut+PL+P2
acclimateriez	acclimater	Ver:CPre+PL+P2
acclimaterions	acclimater	Ver:CPre+PL+P1
acclimaterons	acclimater	Ver:IFut+PL+P1
acclimateront	acclimater	Ver:IFut+PL+P3
acclimates	acclimater	Ver:IPre+SG+P2:SPre+SG+P2
acclimates	acclimater	Ver:PPas+Mas+PL
acclimatez	acclimater	Ver:IPre+PL+P2:ImPre+PL+P2
acclimatiez	acclimater	Ver:IImp+PL+P2:SPre+PL+P2
acclimations	acclimater	Ver:IImp+PL+P1:SPre+PL+P1
acclimatons	acclimater	Ver:IPre+PL+P1:ImPre+PL+P1
accointances	accointances	Nom:Fem+PL
accointant	accointer	Ver:PPre
accointant	accointer	Ver:PPre+Mas+SG
accointe	accointer	Ver:Imp+SG+P2
accointe	accointer	Ver:IPre+SG+P1
accointe	accointer	Ver:IPre+SG+P3
accointe	accointer	Ver:SPre+SG+P1
accointe	accointer	Ver:SPre+SG+P3
accointer	accointer	Ver:Inf
accola	accoler	Ver:IPSim+SG+P3
accolade	accolade	Nom:Fem+SG
accolade	accolader	Ver:Imp+SG+P2
accolade	accolader	Ver:IPre+SG+P1
accolade	accolader	Ver:IPre+SG+P3
accolade	accolader	Ver:SPre+SG+P1
accolade	accolader	Ver:SPre+SG+P3
accolades	accolade	Nom:Fem+PL
accolades	accolader	Ver:IPre+SG+P2
accolades	accolader	Ver:SPre+SG+P2
accolai	accoler	Ver:IPSim+SG+P1
accolaient	accoler	Ver:IImp+PL+P3
accolais	accoler	Ver:IImp+SG+P1:IImp+SG+P2
accolait	accoler	Ver:IImp+SG+P3
accolames	accoler	Ver:IPSim+PL+P1
accolant	accoler	Ver:PPre
accolas	accoler	Ver:IPSim+SG+P2
accolasse	accoler	Ver:SImp+SG+P1
accolassent	accoler	Ver:SImp+PL+P3
accolasses	accoler	Ver:SImp+SG+P2
accolassiez	accoler	Ver:SImp+PL+P2
accolassions	accoler	Ver:SImp+PL+P1
accolat	accoler	Ver:SImp+SG+P3
accolates	accoler	Ver:IPSim+PL+P2
accole	accole	Adj:Mas+SG
accole	accoler	Ver:IPre+SG+P1:IPre+SG+P3:SPre+SG+P1:SPre+SG+P3:ImPre+SG+P2
accole	accoler	Ver:PPas+Mas+SG
accolee	accole	Adj:Fem+SG
accolee	accoler	Ver:PPas+Fem+SG
accolees	accole	Adj:Fem+PL
accolees	accoler	Ver:PPas+Fem+PL
accolent	accoler	Ver:IPre+PL+P3:SPre+PL+P3
accolera	accoler	Ver:IFut+SG+P3
accoler	accoler	Ver:Inf
accolerai	accoler	Ver:IFut+SG+P1
accoleraient	accoler	Ver:CPre+PL+P3
accolerais	accoler	Ver:CPre+SG+P1:CPre+SG+P2
accolerait	accoler	Ver:CPre+SG+P3
accoleras	accoler	Ver:IFut+SG+P2
accolerent	accoler	Ver:IPSim+PL+P3
accolerez	accoler	Ver:IFut+PL+P2
accoleriez	accoler	Ver:CPre+PL+P2
accolerions	accoler	Ver:CPre+PL+P1
accolerons	accoler	Ver:IFut+PL+P1
accoleront	accoler	Ver:IFut+PL+P3
accoles	accole	Adj:Mas+PL
accoles	accoler	Ver:IPre+SG+P2:SPre+SG+P2
accoles	accoler	Ver:PPas+Mas+PL
accolez	accoler	Ver:IPre+PL+P2:ImPre+PL+P2
accoliez	accoler	Ver:IImp+PL+P2:SPre+PL+P2
accolions	accoler	Ver:IImp+PL+P1:SPre+PL+P1
accolons	accoler	Ver:IPre+PL+P1:ImPre+PL+P1
accommoda	accommoder	Ver:IPSim+SG+P3
accommodai	accommoder	Ver:IPSim+SG+P1
accommodaient	accommoder	Ver:IImp+PL+P3
accommodais	accommoder	Ver:IImp+SG+P1:IImp+SG+P2
accommodait	accommoder	Ver:IImp+SG+P3
accommodames	accommoder	Ver:IPSim+PL+P1
accommodant	accommodant	Adj:Mas+SG
accommodant	accommoder	Ver:PPre
accommodante	accommodant	Adj:Fem+SG
accommodantes	accommodant	Adj:Fem+PL
accommodants	accommodant	Adj:Mas+PL
accommodas	accommoder	Ver:IPSim+SG+P2
accommodasse	accommoder	Ver:SImp+SG+P1
accommodassent	accommoder	Ver:SImp+PL+P3
accommodasses	accommoder	Ver:SImp+SG+P2
accommodassiez	accommoder	Ver:SImp+PL+P2
accommodassions	accommoder	Ver:SImp+PL+P1
accommodat	accommodat	Nom:Mas+SG
accommodat	accommoder	Ver:SImp+SG+P3
accommodates	accommoder	Ver:IPSim+PL+P2
accommodateur	accommodateur	Adj:Mas+SG
accommodation	accommodation	Nom:Fem+SG
accommodations	accommodation	Nom:Fem+PL
accommodatrice	accommodateur	Adj:Fem+SG
accommode	accommode	Adj:Mas+SG
accommode	accommoder	Ver:IPre+SG+P1:IPre+SG+P3:SPre+SG+P1:SPre+SG+P3:ImPre+SG+P2
accommodee	accommode	Adj:Fem+SG
accommodees	accommode	Adj:Fem+PL
accommodement	accommodement	Nom:Mas+SG
accommodements	accommodement	Nom:Mas+PL
accommodent	accommoder	Ver:IPre+PL+P3:SPre+PL+P3
accommodera	accommoder	Ver:IFut+SG+P3
accommoder	accommoder	Ver:Inf
accommoderai	accommoder	Ver:IFut+SG+P1
accommoderaient	accommoder	Ver:CPre+PL+P3
accommoderais	accommoder	Ver:CPre+SG+P1:CPre+SG+P2
accommoderait	accommoder	Ver:CPre+SG+P3
accommoderas	accommoder	Ver:IFut+SG+P2
accommoderent	accommoder	Ver:IPSim+PL+P3
accommoderez	accommoder	Ver:IFut+PL+P2
accommoderiez	accommoder	Ver:CPre+PL+P2
accommoderions	accommoder	Ver:CPre+PL+P1
accommoderons	accommoder	Ver:IFut+PL+P1
accommoderont	accommoder	Ver:IFut+PL+P3
accommodes	accommode	Adj:Mas+PL
accommodes	accommoder	Ver:IPre+SG+P2:SPre+SG+P2
accommodez	accommoder	Ver:IPre+PL+P2:ImPre+PL+P2
accommodiez	accommoder	Ver:IImp+PL+P2:SPre+PL+P2
accommodions	accommoder	Ver:IImp+PL+P1:SPre+PL+P1
accommodons	accommoder	Ver:IPre+PL+P1:ImPre+PL+P1
accompagna	accompagner	Ver:IPSim+SG+P3
accompagnai	accompagner	Ver:IPSim+SG+P1
accompagnaient	accompagner	Ver:IImp+PL+P3
accompagnais	accompagner	Ver:IImp+SG+P1:IImp+SG+P2
accompagnait	accompagner	Ver:IImp+SG+P3
accompagnames	accompagner	Ver:IPSim+PL+P1
accompagnant	accompagner	Ver:PPre
accompagnas	accompagner	Ver:IPSim+SG+P2
accompagnasse	accompagner	Ver:SImp+SG+P1
accompagnassent	accompagner	Ver:SImp+PL+P3
accompagnasses	accompagner	Ver:SImp+SG+P2
accompagnassiez	accompagner	Ver:SImp+PL+P2
accompagnassions	accompagner	Ver:SImp+PL+P1
accompagnat	accompagner	Ver:SImp+SG+P3
accompagnates	accompagner	Ver:IPSim+PL+P2
accompagnateur	accompagnateur	Nom:Mas+SG
accompagnateurs	accompagnateur	Nom:Mas+PL
accompagnatrice	accompagnateur	Nom:Fem+SG
accompagnatrices	accompagnateur	Nom:Fem+PL
accompagne	accompagne	Adj:Mas+SG
accompagne	accompagner	Ver:IPre+SG+P1:IPre+SG+P3:SPre+SG+P1:SPre+SG+P3:ImPre+SG+P2
accompagne	accompagner	Ver:PPas+Mas+SG
accompagnee	accompagner	Ver:PPas+Fem+SG
accompagnees	accompagne	Adj:Fem+PL
accompagnees	accompagner	Ver:PPas+Fem+PL
accompagnement	accompagnement	Nom:Mas+SG
accompagnements	accompagnement	Nom:Mas+PL
accompagnent	accompagner	Ver:IPre+PL+P3:SPre+PL+P3
accompagnera	accompagner	Ver:IFut+SG+P3
accompagner	accompagner	Ver:Inf
accompagnerai	accompagner	Ver:IFut+SG+P1
accompagneraient	accompagner	Ver:CPre+PL+P3
accompagnerais	accompagner	Ver:CPre+SG+P1:CPre+SG+P2
accompagnerait	accompagner	Ver:CPre+SG+P3
accompagneras	accompagner	Ver:IFut+SG+P2
accompagnerent	accompagner	Ver:IPSim+PL+P3
accompagnerez	accompagner	Ver:IFut+PL+P2
accompagneriez	accompagner	Ver:CPre+PL+P2
accompagnerions	accompagner	Ver:CPre+PL+P1
accompagnerons	accompagner	Ver:IFut+PL+P1
accompagneront	accompagner	Ver:IFut+PL+P3
accompagnes	accompagner	Ver:IPre+SG+P2:SPre+SG+P2
accompagnes	accompagner	Ver:PPas+Mas+PL
accompagnez	accompagner	Ver:IPre+PL+P2:ImPre+PL+P2
accompagniez	accompagner	Ver:IImp+PL+P2:SPre+PL+P2
accompagnions	accompagner	Ver:IImp+PL+P1:SPre+PL+P1
accompagnons	accompagner	Ver:IPre+PL+P1:ImPre+PL+P1
accompli	accompli	Adj:Mas+SG
accompli	accompli	Nom:Mas+SG
accompli	accomplir	Ver:PPas+Mas+SG
accomplie	accompli	Adj:Fem+SG
accomplie	accomplir	Ver:PPas+Fem+SG
accomplies	accompli	Adj:Fem+PL
accomplies	accomplir	Ver:PPas+Fem+PL
accomplimes	accomplir	Ver:IPSim+PL+P1
accomplira	accomplir	Ver:IFut+SG+P3
accomplir	accomplir	Ver:Inf
accomplirai	accomplir	Ver:IFut+SG+P1
accompliraient	accomplir	Ver:CPre+PL+P3
accomplirais	accomplir	Ver:CPre+SG+P1:CPre+SG+P2
accomplirait	accomplir	Ver:CPre+SG+P3
accompliras	accomplir	Ver:IFut+SG+P2
accomplirent	accomplir	Ver:IPSim+PL+P3
accomplirez	accomplir	Ver:IFut+PL+P2
accompliriez	accomplir	Ver:CPre+PL+P2
accomplirions	accomplir	Ver:CPre+PL+P1
accomplirons	accomplir	Ver:IFut+PL+P1
accompliront	accomplir	Ver:IFut+PL+P3
accomplis	accompli	Adj:Mas+PL
accomplis	accompli	Nom:Mas+PL
accomplis	accomplir	Ver:PPas+Mas+PL:IPre+SG+P1:IPre+SG+P2:IPSim+SG+P1:IPSim+SG+P2:ImPre+SG+P2
accomplissaient	accomplir	Ver:IImp+PL+P3
accomplissais	accomplir	Ver:IImp+SG+P1:IImp+SG+P2
accomplissait	accomplir	Ver:IImp+SG+P3
accomplissant	accomplir	Ver:PPre
accomplissant	accomplir	Ver:PPre
accomplissant	accomplir	Ver:PPre+Mas+SG
accomplisse	accomplir	Ver:SPre+SG+P1:SPre+SG+P3:SImp+SG+P1
accomplissement	accomplissement	Nom:Mas+SG
accomplissements	accomplissement	Nom:Mas+PL
accomplissent	accomplir	Ver:IPre+PL+P3:SPre+PL+P3:SImp+PL+P3
accomplisses	accomplir	Ver:SPre+SG+P2:SImp+SG+P2
accomplissez	accomplir	Ver:IPre+PL+P2:ImPre+PL+P2
accomplissiez	accomplir	Ver:IImp+PL+P2:SPre+PL+P2:SImp+PL+P2
accomplissions	accomplir	Ver:IImp+PL+P1:SPre+PL+P1:SImp+PL+P1
accomplissons	accomplir	Ver:IPre+PL+P1:ImPre+PL+P1
accomplit	accomplir	Ver:IPre+SG+P3:IPSim+SG+P3
accomplit	accomplir	Ver:SImp+SG+P3
accomplites	accomplir	Ver:IPSim+PL+P2
accorant	accorer	Ver:PPre
accorant	accorer	Ver:PPre+Mas+SG
accorda	accorder	Ver:IPSim+SG+P3
accordable	accordable	Adj:InvGen+SG
accord	accord	Nom:Mas+SG
accordai	accorder	Ver:IPSim+SG+P1
accordaient	accorder	Ver:IImp+PL+P3
accordailles	accordailles	Nom:Fem+PL
accordais	accorder	Ver:IImp+SG+P1:IImp+SG+P2
accordait	accorder	Ver:IImp+SG+P3
accordames	accorder	Ver:IPSim+PL+P1
accordant	accorder	Ver:PPre
accordas	accorder	Ver:IPSim+SG+P2
accordasse	accorder	Ver:SImp+SG+P1
accordassent	accorder	Ver:SImp+PL+P3
accordasses	accorder	Ver:SImp+SG+P2
accordassiez	accorder	Ver:SImp+PL+P2
accordassions	accorder	Ver:SImp+PL+P1
accordat	accorder	Ver:SImp+SG+P3
accordates	accorder	Ver:IPSim+PL+P2
accorde	accorde	Adj:Mas+SG
accorde	accorde	Nom:Mas+SG
accorde	accorder	Ver:IPre+SG+P1:IPre+SG+P3:SPre+SG+P1:SPre+SG+P3:ImPre+SG+P2
accorde	accorder	Ver:PPas+Mas+SG
accordee	accorde	Nom:Fem+SG
accordee	accorder	Ver:PPas+Fem+SG
accordees	accorde	Nom:Fem+PL
accordees	accorder	Ver:PPas+Fem+PL
accordement	accordement	Nom:Mas+SG
accordent	accorder	Ver:IPre+PL+P3:SPre+PL+P3
accordeon	accordeon	Nom:Mas+SG
accordeoniste	accordeoniste	Nom:InvGen+SG
accordeonistes	accordeoniste	Nom:InvGen+PL
accordeons	accordeon	Nom:Mas+PL
accordera	accorder	Ver:IFut+SG+P3
accorder	accorder	Ver:Inf
accorderai	accorder	Ver:IFut+SG+P1
accorderaient	accorder	Ver:CPre+PL+P3
accorderais	accorder	Ver:CPre+SG+P1:CPre+SG+P2
accorderait	accorder	Ver:CPre+SG+P3
accorderas	accorder	Ver:IFut+SG+P2
accorderent	accorder	Ver:IPSim+PL+P3
accorderez	accorder	Ver:IFut+PL+P2
accorderiez	accorder	Ver:CPre+PL+P2
accorderions	accorder	Ver:CPre+PL+P1
accorderons	accorder	Ver:IFut+PL+P1
accorderont	accorder	Ver:IFut+PL+P3
accordes	accorde	Nom:Mas+PL
accordes	accorder	Ver:IPre+SG+P2:SPre+SG+P2
accordes	accorder	Ver:PPas+Mas+PL
accordeur	accordeur	Nom:Mas+SG
accordeurs	accordeur	Nom:Mas+PL
accordez	accorder	Ver:Imp+PL+P2
accordez	accorder	Ver:IPre+PL+P2
accordiez	accorder	Ver:IImp+PL+P2:SPre+PL+P2
accordions	accorder	Ver:IImp+PL+P1:SPre+PL+P1
accordoir	accordoir	Nom:Mas+SG
accordons	accorder	Ver:Imp+PL+P1
accordons	accorder	Ver:IPre+PL+P1
accords	accord	Nom:Mas+PL
accore	accore	Adj:InvGen+SG
accore	accore	Nom:Fem+SG
accore	accorer	Ver:IPre+SG+P1:IPre+SG+P3:SPre+SG+P1:SPre+SG+P3:ImPre+SG+P2
accorer	accorer	Ver:Inf
accort	accort	Adj:Mas+SG
accorte	accort	Adj:Fem+SG
accortes	accort	Adj:Fem+PL
accosta	accoster	Ver:IPSim+SG+P3
accostable	accostable	Adj:InvGen+SG
accostage	accostage	Nom:Mas+SG
accostages	accostage	Nom:Mas+PL
accostai	accoster	Ver:IPSim+SG+P1
accostaient	accoster	Ver:IImp+PL+P3
accostais	accoster	Ver:IImp+SG+P1:IImp+SG+P2
accostait	accoster	Ver:IImp+SG+P3
accostames	accoster	Ver:IPSim+PL+P1
accostant	accoster	Ver:PPre
accostas	accoster	Ver:IPSim+SG+P2
accostasse	accoster	Ver:SImp+SG+P1
accostassent	accoster	Ver:SImp+PL+P3
accostasses	accoster	Ver:SImp+SG+P2
accostassiez	accoster	Ver:SImp+PL+P2
accostassions	accoster	Ver:SImp+PL+P1
accostat	accoster	Ver:SImp+SG+P3
accostates	accoster	Ver:IPSim+PL+P2
accoste	accoster	Ver:IPre+SG+P1:IPre+SG+P3:SPre+SG+P1:SPre+SG+P3:ImPre+SG+P2
accoste	accoster	Ver:PPas+Mas+SG
accostee	accoster	Ver:PPas+Fem+SG
accostees	accoster	Ver:PPas+Fem+PL
accostent	accoster	Ver:IPre+PL+P3:SPre+PL+P3
accostera	accoster	Ver:IFut+SG+P3
accoster	accoster	Ver:Inf
accosterai	accoster	Ver:IFut+SG+P1
accosteraient	accoster	Ver:CPre+PL+P3
accosterais	accoster	Ver:CPre+SG+P1:CPre+SG+P2
accosterait	accoster	Ver:CPre+SG+P3
accosteras	accoster	Ver:IFut+SG+P2
accosterent	accoster	Ver:IPSim+PL+P3
accosterez	accoster	Ver:IFut+PL+P2
accosteriez	accoster	Ver:CPre+PL+P2
accosterions	accoster	Ver:CPre+PL+P1
accosterons	accoster	Ver:IFut+PL+P1
accosteront	accoster	Ver:IFut+PL+P3
accostes	accoster	Ver:IPre+SG+P2:SPre+SG+P2
accostes	accoster	Ver:PPas+Mas+PL
accostez	accoster	Ver:IPre+PL+P2:ImPre+PL+P2
accostiez	accoster	Ver:IImp+PL+P2:SPre+PL+P2
accostions	accoster	Ver:IImp+PL+P1:SPre+PL+P1
accostons	accoster	Ver:IPre+PL+P1:ImPre+PL+P1
accota	accoter	Ver:IPSim+SG+P3
accot	accot	Nom:Mas+SG
accotai	accoter	Ver:IPSim+SG+P1
accotaient	accoter	Ver:IImp+PL+P3
accotais	accoter	Ver:IImp+SG+P1:IImp+SG+P2
accotait	accoter	Ver:IImp+SG+P3
accotames	accoter	Ver:IPSim+PL+P1
accotant	accoter	Ver:PPre
accotas	accoter	Ver:IPSim+SG+P2
accotasse	accoter	Ver:SImp+SG+P1
accotassent	accoter	Ver:SImp+PL+P3
accotasses	accoter	Ver:SImp+SG+P2
accotassiez	accoter	Ver:SImp+PL+P2
accotassions	accoter	Ver:SImp+PL+P1
accotat	accoter	Ver:SImp+SG+P3
accotates	accoter	Ver:IPSim+PL+P2
accote	accoter	Ver:IPre+SG+P1:IPre+SG+P3:SPre+SG+P1:SPre+SG+P3:ImPre+SG+P2
accote	accoter	Ver:PPas+Mas+SG
accotement	accotement	Nom:Mas+SG
accotements	accotement	Nom:Mas+PL
accotent	accoter	Ver:IPre+PL+P3:SPre+PL+P3
accoter	accoter	Ver:Inf
accoterent	accoter	Ver:IPSim+PL+P3
accotes	accoter	Ver:IPre+SG+P2:SPre+SG+P2
accotez	accoter	Ver:IPre+PL+P2:ImPre+PL+P2
accotiez	accoter	Ver:IImp+PL+P2:SPre+PL+P2
accotions	accoter	Ver:IImp+PL+P1:SPre+PL+P1
accotoir	accotoir	Nom:Mas+SG
accotons	accoter	Ver:IPre+PL+P1:ImPre+PL+P1
accoua	accouer	Ver:IPSim+SG+P3
accouai	accouer	Ver:IPSim+SG+P1
accouaient	accouer	Ver:IImp+PL+P3
accouais	accouer	Ver:IImp+SG+P1:IImp+SG+P2
accouait	accouer	Ver:IImp+SG+P3
accouames	accouer	Ver:IPSim+PL+P1
accouant	accouer	Ver:PPre
accouas	accouer	Ver:IPSim+SG+P2
accouasse	accouer	Ver:SImp+SG+P1
accouassent	accouer	Ver:SImp+PL+P3
accouasses	accouer	Ver:SImp+SG+P2
accouassiez	accouer	Ver:SImp+PL+P2
accouassions	accouer	Ver:SImp+PL+P1
accouat	accouer	Ver:SImp+SG+P3
accouates	accouer	Ver:IPSim+PL+P2
accoucha	accoucher	Ver:IPSim+SG+P3
accouchai	accoucher	Ver:IPSim+SG+P1
accouchaient	accoucher	Ver:IImp+PL+P3
accouchais	accoucher	Ver:IImp+SG+P1:IImp+SG+P2
accouchait	accoucher	Ver:IImp+SG+P3
accouchames	accoucher	Ver:IPSim+PL+P1
accouchant	accoucher	Ver:PPre
accouchas	accoucher	Ver:IPSim+SG+P2
accouchasse	accoucher	Ver:SImp+SG+P1
accouchassent	accoucher	Ver:SImp+PL+P3
accouchasses	accoucher	Ver:SImp+SG+P2
accouchassiez	accoucher	Ver:SImp+PL+P2
accouchassions	accoucher	Ver:SImp+PL+P1
accouchat	accoucher	Ver:SImp+SG+P3
accouchates	accoucher	Ver:IPSim+PL+P2
accouche	accoucher	Ver:IPre+SG+P1:IPre+SG+P3:SPre+SG+P1:SPre+SG+P3:ImPre+SG+P2
accouche	accoucher	Ver:PPas+Mas+SG
accouchee	accouchee	Nom:Fem+SG
accouchee	accoucher	Ver:PPas+Fem+SG
accouchees	accouchee	Nom:Fem+PL
accouchees	accoucher	Ver:PPas+Fem+PL
accouchement	accouchement	Nom:Mas+SG
accouchements	accouchement	Nom:Mas+PL
accouchent	accoucher	Ver:IPre+PL+P3:SPre+PL+P3
accouchera	accoucher	Ver:IFut+SG+P3
accoucher	accoucher	Ver:Inf
accoucherai	accoucher	Ver:IFut+SG+P1
accoucheraient	accoucher	Ver:CPre+PL+P3
accoucherais	accoucher	Ver:CPre+SG+P1:CPre+SG+P2
accoucherait	accoucher	Ver:CPre+SG+P3
accoucheras	accoucher	Ver:IFut+SG+P2
accoucherent	accoucher	Ver:IPSim+PL+P3
accoucherez	accoucher	Ver:IFut+PL+P2
accoucheriez	accoucher	Ver:CPre+PL+P2
accoucherions	accoucher	Ver:CPre+PL+P1
accoucherons	accoucher	Ver:IFut+PL+P1
accoucheront	accoucher	Ver:IFut+PL+P3
accouches	accoucher	Ver:IPre+SG+P2:SPre+SG+P2
accouches	accoucher	Ver:PPas+Mas+PL
accoucheur	accoucheur	Adj:Mas+SG
accoucheur	accoucheur	Nom:Mas+SG
accoucheurs	accoucheur	Adj:Mas+PL
accoucheurs	accoucheur	Nom:Mas+PL
accoucheuse	accoucheur	Nom:Fem+SG
accoucheuses	accoucheur	Nom:Fem+PL
accouchez	accoucher	Ver:IPre+PL+P2:ImPre+PL+P2
accouchiez	accoucher	Ver:IImp+PL+P2:SPre+PL+P2
accouchions	accoucher	Ver:IImp+PL+P1:SPre+PL+P1
accouchons	accoucher	Ver:IPre+PL+P1:ImPre+PL+P1
accouda	accouder	Ver:IPSim+SG+P3
accoudai	accouder	Ver:IPSim+SG+P1
accoudaient	accouder	Ver:IImp+PL+P3
accoudais	accouder	Ver:IImp+SG+P1:IImp+SG+P2
accoudait	accouder	Ver:IImp+SG+P3
accoudames	accouder	Ver:IPSim+PL+P1
accoudant	accouder	Ver:PPre
accoudas	accouder	Ver:IPSim+SG+P2
accoudasse	accouder	Ver:SImp+SG+P1
accoudassent	accouder	Ver:SImp+PL+P3
accoudasses	accouder	Ver:SImp+SG+P2
accoudassiez	accouder	Ver:SImp+PL+P2
accoudassions	accouder	Ver:SImp+PL+P1
accoudat	accouder	Ver:SImp+SG+P3
accoudates	accouder	Ver:IPSim+PL+P2
accoude	accoude	Adj:Mas+SG
accoude	accouder	Ver:IPre+SG+P1:IPre+SG+P3:SPre+SG+P1:SPre+SG+P3:ImPre+SG+P2
accoude	accouder	Ver:PPas+Mas+SG
accoudee	accoude	Adj:Fem+SG
accoudee	accouder	Ver:PPas+Fem+SG
accoudees	accoude	Adj:Fem+PL
accoudees	accouder	Ver:PPas+Fem+PL
accoudement	accoudement	Nom:Mas+SG
accoudent	accouder	Ver:IPre+PL+P3:SPre+PL+P3
accoudera	accouder	Ver:IFut+SG+P3
accouder	accouder	Ver:Inf
accouderai	accouder	Ver:IFut+SG+P1
accouderaient	accouder	Ver:CPre+PL+P3
accouderais	accouder	Ver:CPre+SG+P1
accouderais	accouder	Ver:CPre+SG+P2
accouderait	accouder	Ver:CPre+SG+P3
accouderas	accouder	Ver:IFut+SG+P2
accouderent	accouder	Ver:IPSim+PL+P3
accouderez	accouder	Ver:IFut+PL+P2
accouderiez	accouder	Ver:CPre+PL+P2
accouderions	accouder	Ver:CPre+PL+P1
accouderons	accouder	Ver:IFut+PL+P1
accouderont	accouder	Ver:IFut+PL+P3
accoudes	accoude	Adj:Mas+PL
accoudes	accouder	Ver:IPre+SG+P2:SPre+SG+P2
accoudes	accouder	Ver:PPas+Mas+PL
accoudez	accouder	Ver:IPre+PL+P2:ImPre+PL+P2
accoudiez	accouder	Ver:IImp+PL+P2:SPre+PL+P2
accoudions	accouder	Ver:IImp+PL+P1:SPre+PL+P1
accoudoir	accoudoir	Nom:Mas+SG
accoudoirs	accoudoir	Nom:Mas+PL
accoudons	accouder	Ver:IPre+PL+P1:ImPre+PL+P1
accoue	accouer	Ver:IPre+SG+P1:IPre+SG+P3:SPre+SG+P1:SPre+SG+P3:ImPre+SG+P2
accoue	accouer	Ver:PPas+Mas+SG
accouent	accouer	Ver:IPre+PL+P3:SPre+PL+P3
accouer	accouer	Ver:Inf
accouerent	accouer	Ver:IPSim+PL+P3
accoues	accouer	Ver:IPre+SG+P2:SPre+SG+P2
accouez	accouer	Ver:IPre+PL+P2:ImPre+PL+P2
accouiez	accouer	Ver:IImp+PL+P2:SPre+PL+P2
accouions	accouer	Ver:IImp+PL+P1:SPre+PL+P1
accouons	accouer	Ver:IPre+PL+P1:ImPre+PL+P1
accoupla	accoupler	Ver:IPSim+SG+P3
accouplai	accoupler	Ver:IPSim+SG+P1
accouplaient	accoupler	Ver:IImp+PL+P3
accouplais	accoupler	Ver:IImp+SG+P1:IImp+SG+P2
accouplait	accoupler	Ver:IImp+SG+P3
accouplames	accoupler	Ver:IPSim+PL+P1
accouplant	accoupler	Ver:PPre
accouplas	accoupler	Ver:IPSim+SG+P2
accouplasse	accoupler	Ver:SImp+SG+P1
accouplassent	accoupler	Ver:SImp+PL+P3
accouplasses	accoupler	Ver:SImp+SG+P2
accouplassiez	accoupler	Ver:SImp+PL+P2
accouplassions	accoupler	Ver:SImp+PL+P1
accouplat	accoupler	Ver:SImp+SG+P3
accouplates	accoupler	Ver:IPSim+PL+P2
accouple	accouple	Adj:Mas+SG
accouple	accouple	Nom:Fem+SG
accouple	accoupler	Ver:IPre+SG+P1:IPre+SG+P3:SPre+SG+P1:SPre+SG+P3:ImPre+SG+P2
accouple	accoupler	Ver:PPas+Mas+SG
accouplee	accouple	Adj:Fem+SG
accouplee	accoupler	Ver:PPas+Fem+SG
accouplees	accouple	Adj:Fem+PL
accouplees	accoupler	Ver:PPas+Fem+PL
accouplement	accouplement	Nom:Mas+SG
accouplements	accouplement	Nom:Mas+PL
accouplent	accoupler	Ver:IPre+PL+P3:SPre+PL+P3
accouplera	accoupler	Ver:IFut+SG+P3
accoupler	accoupler	Ver:Inf
accouplerai	accoupler	Ver:IFut+SG+P1
accoupleraient	accoupler	Ver:CPre+PL+P3
accouplerais	accoupler	Ver:CPre+SG+P1:CPre+SG+P2
accouplerait	accoupler	Ver:CPre+SG+P3
accoupleras	accoupler	Ver:IFut+SG+P2
accouplerent	accoupler	Ver:IPSim+PL+P3
accouplerez	accoupler	Ver:IFut+PL+P2
accoupleriez	accoupler	Ver:CPre+PL+P2
accouplerions	accoupler	Ver:CPre+PL+P1
accouplerons	accoupler	Ver:IFut+PL+P1
accoupleront	accoupler	Ver:IFut+PL+P3
accouples	accouple	Adj:Mas+PL
accouples	accouple	Nom:Fem+PL
accouples	accoupler	Ver:IPre+SG+P2:SPre+SG+P2
accouples	accoupler	Ver:PPas+Mas+PL
accouplez	accoupler	Ver:IPre+PL+P2:ImPre+PL+P2
accoupliez	accoupler	Ver:IImp+PL+P2:SPre+PL+P2
accouplions	accoupler	Ver:IImp+PL+P1:SPre+PL+P1
accouplons	accoupler	Ver:IPre+PL+P1:ImPre+PL+P1
accouraient	accourir	Ver:IImp+PL+P3
accourais	accourir	Ver:IImp+SG+P1:IImp+SG+P2
accourait	accourir	Ver:IImp+SG+P3
accourant	accourir	Ver:PPre
accourci	accourcir	Ver:PPas+Mas+SG
accourcie	accourcir	Ver:PPas+Fem+SG
accourcies	accourcir	Ver:PPas+Fem+PL
accourcimes	accourcir	Ver:IPSim+PL+P1
accourcira	accourcir	Ver:IFut+SG+P3
accourcir	accourcir	Ver:Inf
accourcirai	accourcir	Ver:IFut+SG+P1
accourciraient	accourcir	Ver:CPre+PL+P3
accourcirais	accourcir	Ver:CPre+SG+P1:CPre+SG+P2
accourcirait	accourcir	Ver:CPre+SG+P3
accourciras	accourcir	Ver:IFut+SG+P2
accourcirent	accourcir	Ver:IPSim+PL+P3
accourcirez	accourcir	Ver:IFut+PL+P2
accourciriez	accourcir	Ver:CPre+PL+P2
accourcirions	accourcir	Ver:CPre+PL+P1
accourcirons	accourcir	Ver:IFut+PL+P1
accourciront	accourcir	Ver:IFut+PL+P3
accourcis	accourcir	Ver:PPas+Mas+PL:IPre+SG+P1:IPre+SG+P2:IPSim+SG+P1:IPSim+SG+P2:ImPre+SG+P2
accourcissaient	accourcir	Ver:IImp+PL+P3
accourcissais	accourcir	Ver:IImp+SG+P1
accourcissais	accourcir	Ver:IImp+SG+P2
accourcissait	accourcir	Ver:IImp+SG+P3
accourcissant	accourcir	Ver:PPre
accourcissant	accourcir	Ver:PPre
accourcissant	accourcir	Ver:PPre+Mas+SG
accourcisse	accourcir	Ver:SImp+SG+P1
accourcisse	accourcir	Ver:SPre+SG+P1
accourcisse	accourcir	Ver:SPre+SG+P3
accourcissement	accourcissement	Nom:Mas+SG
accourcissent	accourcir	Ver:IPre+PL+P3
accourcissent	accourcir	Ver:SImp+PL+P3
accourcissent	accourcir	Ver:SPre+PL+P3
accourcisses	accourcir	Ver:SImp+SG+P2
accourcisses	accourcir	Ver:SPre+SG+P2
accourcissez	accourcir	Ver:Imp+PL+P2
accourcissez	accourcir	Ver:IPre+PL+P2
accourcissiez	accourcir	Ver:IImp+PL+P2:SPre+PL+P2:SImp+PL+P2
accourcissions	accourcir	Ver:IImp+PL+P1:SPre+PL+P1:SImp+PL+P1
accourcissons	accourcir	Ver:Imp+PL+P1
accourcissons	accourcir	Ver:IPre+PL+P1
accourcit	accourcir	Ver:IPre+SG+P3:IPSim+SG+P3
accourcit	accourcir	Ver:SImp+SG+P3
accourcites	accourcir	Ver:IPSim+PL+P2
accoure	accourir	Ver:SPre+SG+P1:SPre+SG+P3
accourent	accourir	Ver:IPre+PL+P3:SPre+PL+P3
accoures	accourir	Ver:SPre+SG+P2
accourez	accourir	Ver:IPre+PL+P2:ImPre+PL+P2
accouriez	accourir	Ver:IImp+PL+P2:SPre+PL+P2
accourions	accourir	Ver:IImp+PL+P1:SPre+PL+P1
accourir	accourir	Ver:Inf
accourons	accourir	Ver:IPre+PL+P1:ImPre+PL+P1
accourra	accourir	Ver:IFut+SG+P3
accourrai	accourir	Ver:IFut+SG+P1
accourraient	accourir	Ver:CPre+PL+P3
accourrais	accourir	Ver:CPre+SG+P1:CPre+SG+P2
accourrait	accourir	Ver:CPre+SG+P3
accourras	accourir	Ver:IFut+SG+P2
accourrez	accourir	Ver:IFut+PL+P2
accourriez	accourir	Ver:CPre+PL+P2
accourrions	accourir	Ver:CPre+PL+P1
accourrons	accourir	Ver:IFut+PL+P1
accourront	accourir	Ver:IFut+PL+P3
accours	accourir	Ver:IPre+SG+P1:IPre+SG+P2:ImPre+SG+P2
accourt	accourir	Ver:IPre+SG+P3
accouru	accourir	Ver:PPas+Mas+SG
accourue	accourir	Ver:PPas+Fem+SG
accourues	accourir	Ver:PPas+Fem+PL
accourumes	accourir	Ver:IPSim+PL+P1
accoururent	accourir	Ver:IPSim+PL+P3
accourus	accourir	Ver:IPSim+SG+P1:IPSim+SG+P2
accourusse	accourir	Ver:SImp+SG+P1
accourussent	accourir	Ver:SImp+PL+P3
accourusses	accourir	Ver:SImp+SG+P2
accourussiez	accourir	Ver:SImp+PL+P2
accourussions	accourir	Ver:SImp+PL+P1
accourut	accourir	Ver:IPSim+SG+P3
accourut	accourir	Ver:SImp+SG+P3
accourutes	accourir	Ver:IPSim+PL+P2
accoutra	accoutrer	Ver:IPSim+SG+P3
accoutrai	accoutrer	Ver:IPSim+SG+P1
accoutraient	accoutrer	Ver:IImp+PL+P3
accoutrais	accoutrer	Ver:IImp+SG+P1:IImp+SG+P2
accoutrait	accoutrer	Ver:IImp+SG+P3
accoutrames	accoutrer	Ver:IPSim+PL+P1
accoutrant	accoutrer	Ver:PPre
accoutras	accoutrer	Ver:IPSim+SG+P2
accoutrasse	accoutrer	Ver:SImp+SG+P1
accoutrassent	accoutrer	Ver:SImp+PL+P3
accoutrasses	accoutrer	Ver:SImp+SG+P2
accoutrassiez	accoutrer	Ver:SImp+PL+P2
accoutrassions	accoutrer	Ver:SImp+PL+P1
accoutrat	accoutrer	Ver:SImp+SG+P3
accoutrates	accoutrer	Ver:IPSim+PL+P2
accoutre	accoutrer	Ver:IPre+SG+P1:IPre+SG+P3:SPre+SG+P1:SPre+SG+P3:ImPre+SG+P2
accoutre	accoutrer	Ver:PPas+Mas+SG
accoutrement	accoutrement	Nom:Mas+SG
accoutrements	accoutrement	Nom:Mas+PL
accoutrent	accoutrer	Ver:IPre+PL+P3:SPre+PL+P3
accoutrer	accoutrer	Ver:Inf
accoutrerent	accoutrer	Ver:IPSim+PL+P3
accoutres	accoutrer	Ver:IPre+SG+P2:SPre+SG+P2
accoutrez	accoutrer	Ver:IPre+PL+P2:ImPre+PL+P2
accoutriez	accoutrer	Ver:IImp+PL+P2:SPre+PL+P2
accoutrions	accoutrer	Ver:IImp+PL+P1:SPre+PL+P1
accoutrons	accoutrer	Ver:IPre+PL+P1:ImPre+PL+P1
accoutuma	accoutumer	Ver:IPSim+SG+P3
accoutumai	accoutumer	Ver:IPSim+SG+P1
accoutumaient	accoutumer	Ver:IImp+PL+P3
accoutumais	accoutumer	Ver:IImp+SG+P1:IImp+SG+P2
accoutumait	accoutumer	Ver:IImp+SG+P3
accoutumames	accoutumer	Ver:IPSim+PL+P1
accoutumance	accoutumance	Nom:Fem+SG
accoutumant	accoutumer	Ver:PPre
accoutumas	accoutumer	Ver:IPSim+SG+P2
accoutumasse	accoutumer	Ver:SImp+SG+P1
accoutumassent	accoutumer	Ver:SImp+PL+P3
accoutumasses	accoutumer	Ver:SImp+SG+P2
accoutumassiez	accoutumer	Ver:SImp+PL+P2
accoutumassions	accoutumer	Ver:SImp+PL+P1
accoutumat	accoutumer	Ver:SImp+SG+P3
accoutumates	accoutumer	Ver:IPSim+PL+P2
accoutume	accoutume	Adj:Mas+SG
accoutume	accoutumer	Ver:Imp+SG+P2
accoutume	accoutumer	Ver:IPre+SG+P1
accoutume	accoutumer	Ver:IPre+SG+P3
accoutume	accoutumer	Ver:PPas+Mas+SG
accoutume	accoutumer	Ver:SPre+SG+P1
accoutume	accoutumer	Ver:SPre+SG+P3
accoutumee	accoutume	Adj:Fem+SG
accoutumee	accoutumee	Nom:Fem+SG
accoutumee	accoutumer	Ver:PPas+Fem+SG
accoutumees	accoutume	Adj:Fem+PL
accoutumees	accoutumer	Ver:PPas+Fem+PL
accoutument	accoutumer	Ver:IPre+PL+P3:SPre+PL+P3
accoutumera	accoutumer	Ver:IFut+SG+P3
accoutumer	accoutumer	Ver:Inf
accoutumerai	accoutumer	Ver:IFut+SG+P1
accoutumeraient	accoutumer	Ver:CPre+PL+P3
accoutumerais	accoutumer	Ver:CPre+SG+P1:CPre+SG+P2
accoutumerait	accoutumer	Ver:CPre+SG+P3
accoutumeras	accoutumer	Ver:IFut+SG+P2
accoutumerent	accoutumer	Ver:IPSim+PL+P3
accoutumerez	accoutumer	Ver:IFut+PL+P2
accoutumeriez	accoutumer	Ver:CPre+PL+P2
accoutumerions	accoutumer	Ver:CPre+PL+P1
accoutumerons	accoutumer	Ver:IFut+PL+P1
accoutumeront	accoutumer	Ver:IFut+PL+P3
accoutumes	accoutume	Adj:Mas+PL
accoutumes	accoutumer	Ver:IPre+SG+P2
accoutumes	accoutumer	Ver:PPas+Mas+PL
accoutumes	accoutumer	Ver:SPre+SG+P2
accoutumez	accoutumer	Ver:IPre+PL+P2:ImPre+PL+P2
accoutumiez	accoutumer	Ver:IImp+PL+P2:SPre+PL+P2
accoutumions	accoutumer	Ver:IImp+PL+P1:SPre+PL+P1
accoutumons	accoutumer	Ver:IPre+PL+P1:ImPre+PL+P1
accouvage	accouvage	Nom:Mas+SG
accredita	accrediter	Ver:IPSim+SG+P3
accreditai	accrediter	Ver:IPSim+SG+P1
accreditaient	accrediter	Ver:IImp+PL+P3
accreditais	accrediter	Ver:IImp+SG+P1:IImp+SG+P2
accreditait	accrediter	Ver:IImp+SG+P3
accreditames	accrediter	Ver:IPSim+PL+P1
accreditant	accreditant	Adj:Mas+SG
accreditant	accrediter	Ver:PPre
accreditas	accrediter	Ver:IPSim+SG+P2
accreditasse	accrediter	Ver:SImp+SG+P1
accreditassent	accrediter	Ver:SImp+PL+P3
accreditasses	accrediter	Ver:SImp+SG+P2
accreditassiez	accrediter	Ver:SImp+PL+P2
accreditassions	accrediter	Ver:SImp+PL+P1
accreditat	accrediter	Ver:SImp+SG+P3
accreditates	accrediter	Ver:IPSim+PL+P2
accreditation	accreditation	Nom:Fem+SG
accreditations	accreditation	Nom:Fem+PL
accredite	accredite	Adj:Mas+SG
accredite	accredite	Nom:Mas+SG
accredite	accrediter	Ver:IPre+SG+P1:IPre+SG+P3:SPre+SG+P1:SPre+SG+P3:ImPre+SG+P2
accredite	accrediter	Ver:PPas+Mas+SG
accreditee	accredite	Adj:Fem+SG
accreditee	accredite	Nom:Fem+SG
accreditee	accrediter	Ver:PPas+Fem+SG
accreditees	accredite	Adj:Fem+PL
accreditees	accredite	Nom:Fem+PL
accreditees	accrediter	Ver:PPas+Fem+PL
accreditent	accrediter	Ver:IPre+PL+P3:SPre+PL+P3
accreditera	accrediter	Ver:IFut+SG+P3
accrediter	accrediter	Ver:Inf
accrediterai	accrediter	Ver:IFut+SG+P1
accrediteraient	accrediter	Ver:CPre+PL+P3
accrediterais	accrediter	Ver:CPre+SG+P1:CPre+SG+P2
accrediterait	accrediter	Ver:CPre+SG+P3
accrediteras	accrediter	Ver:IFut+SG+P2
accrediterent	accrediter	Ver:IPSim+PL+P3
accrediterez	accrediter	Ver:IFut+PL+P2
accrediteriez	accrediter	Ver:CPre+PL+P2
accrediterions	accrediter	Ver:CPre+PL+P1
accrediterons	accrediter	Ver:IFut+PL+P1
accrediteront	accrediter	Ver:IFut+PL+P3
accredites	accredite	Adj:Mas+PL
accredites	accredite	Nom:Mas+PL
accredites	accrediter	Ver:IPre+SG+P2:SPre+SG+P2
accredites	accrediter	Ver:PPas+Mas+PL
accrediteur	accrediteur	Nom:Mas+SG
accrediteurs	accrediteur	Nom:Mas+PL
accreditez	accrediter	Ver:IPre+PL+P2:ImPre+PL+P2
accreditiez	accrediter	Ver:IImp+PL+P2:SPre+PL+P2
accreditif	accreditif	Adj:Mas+SG
accreditif	accreditif	Nom:Mas+SG
accreditifs	accreditif	Adj:Mas+PL
accreditifs	accreditif	Nom:Mas+PL
accreditions	accrediter	Ver:IImp+PL+P1:SPre+PL+P1
accreditive	accreditif	Adj:Fem+SG
accreditives	accreditif	Adj:Fem+PL
accreditons	accrediter	Ver:IPre+PL+P1:ImPre+PL+P1
accrescent	accrescent	Adj:Mas+SG
accrescente	accrescent	Adj:Fem+SG
accrescentes	accrescent	Adj:Fem+PL
accretion	accretion	Nom:Fem+SG
accroc	accroc	Nom:Mas+SG
accrocha	accrocher	Ver:IPSim+SG+P3
accrochage	accrochage	Nom:Mas+SG
accrochages	accrochage	Nom:Mas+PL
accrochai	accrocher	Ver:IPSim+SG+P1
accrochaient	accrocher	Ver:IImp+PL+P3
accrochais	accrocher	Ver:IImp+SG+P1
accrochais	accrocher	Ver:IImp+SG+P2
accrochait	accrocher	Ver:IImp+SG+P3
accrochames	accrocher	Ver:IPSim+PL+P1
accrochant	accrocher	Ver:PPre
accrochas	accrocher	Ver:IPSim+SG+P2
accrochasse	accrocher	Ver:SImp+SG+P1
accrochassent	accrocher	Ver:SImp+PL+P3
accrochasses	accrocher	Ver:SImp+SG+P2
accrochassiez	accrocher	Ver:SImp+PL+P2
accrochassions	accrocher	Ver:SImp+PL+P1
accrochat	accrocher	Ver:SImp+SG+P3
accrochates	accrocher	Ver:IPSim+PL+P2
accroche	accroche	Adj:Mas+SG
accroche	accroche	Nom:Fem+SG
accroche	accrocher	Ver:Imp+SG+P2
accroche	accrocher	Ver:IPre+SG+P1
accroche	accrocher	Ver:IPre+SG+P3
accroche	accrocher	Ver:PPas+Mas+SG
accroche	accrocher	Ver:SPre+SG+P1
accroche	accrocher	Ver:SPre+SG+P3
accrochee	accroche	Adj:Fem+SG
accrochee	accrocher	Ver:PPas+Fem+SG
accrochees	accroche	Adj:Fem+PL
accrochees	accrocher	Ver:PPas+Fem+PL
accrochent	accrocher	Ver:IPre+PL+P3
accrochent	accrocher	Ver:SPre+PL+P3
accrochera	accrocher	Ver:IFut+SG+P3
accrocher	accrocher	Ver:Inf
accrocherai	accrocher	Ver:IFut+SG+P1
accrocheraient	accrocher	Ver:CPre+PL+P3
accrocherais	accrocher	Ver:CPre+SG+P1:CPre+SG+P2
accrocherait	accrocher	Ver:CPre+SG+P3
accrocheras	accrocher	Ver:IFut+SG+P2
accrocherent	accrocher	Ver:IPSim+PL+P3
accrocherez	accrocher	Ver:IFut+PL+P2
accrocheriez	accrocher	Ver:CPre+PL+P2
accrocherions	accrocher	Ver:CPre+PL+P1
accrocherons	accrocher	Ver:IFut+PL+P1
accrocheront	accrocher	Ver:IFut+PL+P3
accroches	accroche	Adj:Mas+PL
accroches	accroche	Nom:Fem+PL
accroches	accrocher	Ver:IPre+SG+P2
accroches	accrocher	Ver:PPas+Mas+PL
accroches	accrocher	Ver:SPre+SG+P2
accrocheur	accrocheur	Adj:Mas+SG
accrocheur	accrocheur	Nom:Mas+SG
accrocheurs	accrocheur	Adj:Mas+PL
accrocheurs	accrocheur	Nom:Mas+PL
accrocheuse	accrocheur	Adj:Fem+SG
accrocheuse	accrocheur	Nom:Fem+SG
accrocheuses	accrocheur	Adj:Fem+PL
accrocheuses	accrocheur	Nom:Fem+PL
accrochez	accrocher	Ver:IPre+PL+P2:ImPre+PL+P2
accroche-coeur	accroche-coeur	Nom:Mas+InvPL
accroche-coeur	accroche-coeur	Nom:Mas+SG
accrochiez	accrocher	Ver:IImp+PL+P2
accrochiez	accrocher	Ver:SPre+PL+P2
accrochions	accrocher	Ver:IImp+PL+P1
accrochions	accrocher	Ver:SPre+PL+P1
accrochons	accrocher	Ver:IPre+PL+P1:ImPre+PL+P1
accrocs	accroc	Nom:Mas+PL
accroie	accroire	Ver:SPre+SG+P1
accroie	accroire	Ver:SPre+SG+P3
accroient	accroire	Ver:IPre+PL+P3
accroient	accroire	Ver:SPre+PL+P3
accroies	accroire	Ver:SPre+SG+P2
accroire	accroire	Ver:Inf
accrois	accroitre	Ver:IPre+SG+P1:IPre+SG+P2:ImPre+SG+P2
accroissaient	accroitre	Ver:IImp+PL+P3
accroissais	accroitre	Ver:IImp+SG+P1:IImp+SG+P2
accroissait	accroitre	Ver:IImp+SG+P3
accroissant	accroitre	Ver:PPre
accroisse	accroitre	Ver:SPre+SG+P1:SPre+SG+P3
accroissement	accroissement	Nom:Mas+SG
accroissements	accroissement	Nom:Mas+PL
accroissent	accroitre	Ver:IPre+PL+P3:SPre+PL+P3
accroisses	accroitre	Ver:SPre+SG+P2
accroissez	accroitre	Ver:IPre+PL+P2:ImPre+PL+P2
accroissiez	accroitre	Ver:IImp+PL+P2:SPre+PL+P2
accroissions	accroitre	Ver:IImp+PL+P1:SPre+PL+P1
accroissons	accroitre	Ver:IPre+PL+P1:ImPre+PL+P1
accroit	accroitre	Ver:IPre+SG+P3
accroitra	accroitre	Ver:IFut+SG+P3
accroitrai	accroitre	Ver:IFut+SG+P1
accroitraient	accroitre	Ver:CPre+PL+P3
accroitrais	accroitre	Ver:CPre+SG+P1:CPre+SG+P2
accroitrait	accroitre	Ver:CPre+SG+P3
accroitras	accroitre	Ver:IFut+SG+P2
accroitre	accroitre	Ver:Inf
accroitrez	accroitre	Ver:IFut+PL+P2
accroitriez	accroitre	Ver:CPre+PL+P2
accroitrions	accroitre	Ver:CPre+PL+P1
accroitrons	accroitre	Ver:IFut+PL+P1
accroitront	accroitre	Ver:IFut+PL+P3
accroupi	accroupir	Ver:PPas+Mas+SG
accroupie	accroupir	Ver:PPas+Fem+SG
accroupies	accroupir	Ver:PPas+Fem+PL
accroupimes	accroupir	Ver:IPSim+PL+P1
accroupira	accroupir	Ver:IFut+SG+P3
accroupir	accroupir	Ver:Inf
accroupirai	accroupir	Ver:IFut+SG+P1
accroupiraient	accroupir	Ver:CPre+PL+P3
accroupirais	accroupir	Ver:CPre+SG+P1
accroupirais	accroupir	Ver:CPre+SG+P2
accroupirait	accroupir	Ver:CPre+SG+P3
accroupiras	accroupir	Ver:IFut+SG+P2
accroupirent	accroupir	Ver:IPSim+PL+P3
accroupirez	accroupir	Ver:IFut+PL+P2
accroupiriez	accroupir	Ver:CPre+PL+P2
accroupirions	accroupir	Ver:CPre+PL+P1
accroupirons	accroupir	Ver:IFut+PL+P1
accroupiront	accroupir	Ver:IFut+PL+P3
accroupis	accroupir	Ver:Imp+SG+P2
accroupis	accroupir	Ver:IPre+SG+P1
accroupis	accroupir	Ver:IPre+SG+P2
accroupis	accroupir	Ver:PPas+Mas+PL
accroupis	accroupir	Ver:IPSim+SG+P1
accroupis	accroupir	Ver:IPSim+SG+P2
accroupissaient	accroupir	Ver:IImp+PL+P3
accroupissais	accroupir	Ver:IImp+SG+P1
accroupissais	accroupir	Ver:IImp+SG+P2
accroupissait	accroupir	Ver:IImp+SG+P3
accroupissant	accroupir	Ver:PPre
accroupissant	accroupir	Ver:PPre
accroupissant	accroupir	Ver:PPre+Mas+SG
accroupisse	accroupir	Ver:SImp+SG+P1
accroupisse	accroupir	Ver:SPre+SG+P1
accroupisse	accroupir	Ver:SPre+SG+P3
accroupissement	accroupissement	Nom:Mas+SG
accroupissent	accroupir	Ver:IPre+PL+P3
accroupissent	accroupir	Ver:SImp+PL+P3
accroupissent	accroupir	Ver:SPre+PL+P3
accroupisses	accroupir	Ver:SImp+SG+P2
accroupisses	accroupir	Ver:SPre+SG+P2
accroupissez	accroupir	Ver:Imp+PL+P2
accroupissez	accroupir	Ver:IPre+PL+P2
accroupissiez	accroupir	Ver:IImp+PL+P2
accroupissiez	accroupir	Ver:SImp+PL+P2
accroupissiez	accroupir	Ver:SPre+PL+P2
accroupissions	accroupir	Ver:IImp+PL+P1
accroupissions	accroupir	Ver:SImp+PL+P1
accroupissions	accroupir	Ver:SPre+PL+P1
accroupissons	accroupir	Ver:Imp+PL+P1
accroupissons	accroupir	Ver:IPre+PL+P1
accroupit	accroupir	Ver:IPre+SG+P3
accroupit	accroupir	Ver:IPSim+SG+P3
accroupit	accroupir	Ver:SImp+SG+P3
accroupites	accroupir	Ver:IPSim+PL+P2
accroyaient	accroire	Ver:IImp+PL+P3
accroyais	accroire	Ver:IImp+SG+P1
accroyais	accroire	Ver:IImp+SG+P2
accroyait	accroire	Ver:IImp+SG+P3
accroyant	accroire	Ver:PPre
accroyant	accroire	Ver:PPre+Mas+SG
accroyez	accroire	Ver:Imp+PL+P2
accroyez	accroire	Ver:IPre+PL+P2
accroyiez	accroire	Ver:IImp+PL+P2
accroyiez	accroire	Ver:SPre+PL+P2
accroyions	accroire	Ver:IImp+PL+P1
accroyions	accroire	Ver:SPre+PL+P1
accroyons	accroire	Ver:Imp+PL+P1
accroyons	accroire	Ver:IPre+PL+P1
accru	accroitre	Ver:PPas+Mas+SG
accru	accru	Adj:Mas+SG
accru	accru	Nom:Mas+SG
accrue	accroitre	Ver:PPas+Fem+SG
accrue	accru	Adj:Fem+SG
accrue	accrue	Nom:Fem+SG
accrues	accroitre	Ver:PPas+Fem+PL
accrues	accru	Adj:Fem+PL
accrues	accrue	Nom:Fem+PL
accrumes	accroire	Ver:IPSim+PL+P1
accrumes	accroitre	Ver:IPSim+PL+P1
accrurent	accroitre	Ver:IPSim+PL+P3
accrus	accroitre	Ver:PPas+Mas+PL:IPSim+SG+P1:IPSim+SG+P2
accrus	accru	Adj:Mas+PL
accrus	accru	Nom:Mas+PL
accrusse	accroire	Ver:SImp+SG+P1
accrusse	accroitre	Ver:SImp+SG+P1
accrussent	accroire	Ver:SImp+PL+P3
accrussent	accroitre	Ver:SImp+PL+P3
accrusses	accroire	Ver:SImp+SG+P2
accrusses	accroitre	Ver:SImp+SG+P2
accrussiez	accroire	Ver:SImp+PL+P2
accrussiez	accroitre	Ver:SImp+PL+P2
accrussions	accroire	Ver:SImp+PL+P1
accrussions	accroitre	Ver:SImp+PL+P1
accrut	accroire	Ver:SImp+SG+P3
accrut	accroitre	Ver:IPSim+SG+P3
accrut	accroitre	Ver:SImp+SG+P3
accrutes	accroire	Ver:IPSim+PL+P2
accrutes	accroitre	Ver:IPSim+PL+P2
accu	accu	Nom:Mas+SG
accueil	accueil	Nom:Mas+SG
accueillaient	accueillir	Ver:IImp+PL+P3
accueillais	accueillir	Ver:IImp+SG+P1:IImp+SG+P2
accueillait	accueillir	Ver:IImp+SG+P3
accueillant	accueillant	Adj:Mas+SG
accueillant	accueillir	Ver:PPre
accueillante	accueillant	Adj:Fem+SG
accueillantes	accueillant	Adj:Fem+PL
accueillants	accueillant	Adj:Mas+PL
accueille	accueillir	Ver:IPre+SG+P1:IPre+SG+P3:SPre+SG+P1:SPre+SG+P3:ImPre+SG+P2
accueillent	accueillir	Ver:IPre+PL+P3:SPre+PL+P3
accueillera	accueillir	Ver:IFut+SG+P3
accueillerai	accueillir	Ver:IFut+SG+P1
accueilleraient	accueillir	Ver:CPre+PL+P3
accueillerais	accueillir	Ver:CPre+SG+P1:CPre+SG+P2
accueillerait	accueillir	Ver:CPre+SG+P3
accueilleras	accueillir	Ver:IFut+SG+P2
accueillerez	accueillir	Ver:IFut+PL+P2
accueilleriez	accueillir	Ver:CPre+PL+P2
accueillerions	accueillir	Ver:CPre+PL+P1
accueillerons	accueillir	Ver:IFut+PL+P1
accueilleront	accueillir	Ver:IFut+PL+P3
accueilles	accueillir	Ver:IPre+SG+P2:SPre+SG+P2
accueillez	accueillir	Ver:IPre+PL+P2:ImPre+PL+P2
accueilli	accueillir	Ver:PPas+Mas+SG
accueillie	accueillir	Ver:PPas+Fem+SG
accueillies	accueillir	Ver:PPas+Fem+PL
accueilliez	accueillir	Ver:IImp+PL+P2
accueilliez	accueillir	Ver:SPre+PL+P2
accueillimes	accueillir	Ver:IPSim+PL+P1
accueillions	accueillir	Ver:IImp+PL+P1:SPre+PL+P1
accueillir	accueillir	Ver:Inf
accueillirent	accueillir	Ver:IPSim+PL+P3
accueillis	accueillir	Ver:PPas+Mas+PL:IPSim+SG+P1:IPSim+SG+P2
accueillis	accueillir	Ver:IPSim+SG+P1:IPSim+SG+P2
accueillissent	accueillir	Ver:SImp+PL+P3
accueillisses	accueillir	Ver:SImp+SG+P2
accueillissiez	accueillir	Ver:SImp+PL+P2
accueillissions	accueillir	Ver:SImp+PL+P1
accueillit	accueillir	Ver:IPSim+SG+P3
accueillit	accueillir	Ver:SImp+SG+P3
accueillites	accueillir	Ver:IPSim+PL+P2
accueillons	accueillir	Ver:IPre+PL+P1:ImPre+PL+P1
accueils	accueil	Nom:Mas+PL
accula	acculer	Ver:IPSim+SG+P3
acculai	acculer	Ver:IPSim+SG+P1
acculaient	acculer	Ver:IImp+PL+P3
acculais	acculer	Ver:IImp+SG+P1:IImp+SG+P2
acculait	acculer	Ver:IImp+SG+P3
acculames	acculer	Ver:IPSim+PL+P1
acculant	acculer	Ver:PPre
acculas	acculer	Ver:IPSim+SG+P2
acculasse	acculer	Ver:SImp+SG+P1
acculassent	acculer	Ver:SImp+PL+P3
acculasses	acculer	Ver:SImp+SG+P2
acculassiez	acculer	Ver:SImp+PL+P2
acculassions	acculer	Ver:SImp+PL+P1
acculat	acculer	Ver:SImp+SG+P3
acculates	acculer	Ver:IPSim+PL+P2
accule	acculer	Ver:IPre+SG+P1:IPre+SG+P3:SPre+SG+P1:SPre+SG+P3:ImPre+SG+P2
accule	acculer	Ver:PPas+Mas+SG
acculee	acculee	Nom:Fem+SG
acculee	acculer	Ver:PPas+Fem+SG
acculees	acculee	Nom:Fem+PL
acculees	acculer	Ver:PPas+Fem+PL
acculent	acculer	Ver:IPre+PL+P3:SPre+PL+P3
acculera	acculer	Ver:IFut+SG+P3
acculer	acculer	Ver:Inf
acculerai	acculer	Ver:IFut+SG+P1
acculeraient	acculer	Ver:CPre+PL+P3
acculerais	acculer	Ver:CPre+SG+P1:CPre+SG+P2
acculerait	acculer	Ver:CPre+SG+P3
acculeras	acculer	Ver:IFut+SG+P2
acculerent	acculer	Ver:IPSim+PL+P3
acculerez	acculer	Ver:IFut+PL+P2
acculeriez	acculer	Ver:CPre+PL+P2
acculerions	acculer	Ver:CPre+PL+P1
acculerons	acculer	Ver:IFut+PL+P1
acculeront	acculer	Ver:IFut+PL+P3
accules	acculer	Ver:IPre+SG+P2:SPre+SG+P2
accules	acculer	Ver:PPas+Mas+PL
acculez	acculer	Ver:IPre+PL+P2:ImPre+PL+P2
acculiez	acculer	Ver:IImp+PL+P2:SPre+PL+P2
acculions	acculer	Ver:IImp+PL+P1:SPre+PL+P1
acculons	acculer	Ver:Imp+PL+P1
acculons	acculer	Ver:IPre+PL+P1
acculturation	acculturation	Nom:Fem+SG
acculturations	acculturation	Nom:Fem+PL
acculturer	acculturer	Ver:Inf
accumula	accumuler	Ver:IPSim+SG+P3
accumulai	accumuler	Ver:IPSim+SG+P1
accumulaient	accumuler	Ver:IImp+PL+P3
accumulais	accumuler	Ver:IImp+SG+P1:IImp+SG+P2
accumulait	accumuler	Ver:IImp+SG+P3
accumulames	accumuler	Ver:IPSim+PL+P1
accumulant	accumuler	Ver:PPre
accumulas	accumuler	Ver:IPSim+SG+P2
accumulasse	accumuler	Ver:SImp+SG+P1
accumulassent	accumuler	Ver:SImp+PL+P3
accumulasses	accumuler	Ver:SImp+SG+P2
accumulassiez	accumuler	Ver:SImp+PL+P2
accumulassions	accumuler	Ver:SImp+PL+P1
accumulat	accumuler	Ver:SImp+SG+P3
accumulates	accumuler	Ver:IPSim+PL+P2
accumulateur	accumulateur	Adj:Mas+SG
accumulateur	accumulateur	Nom:Mas+SG
accumulateurs	accumulateur	Adj:Mas+PL
accumulateurs	accumulateur	Nom:Mas+PL
accumulation	accumulation	Nom:Fem+SG
accumulations	accumulation	Nom:Fem+PL
accumule	accumule	Adj:Mas+SG
accumule	accumuler	Ver:IPre+SG+P1:IPre+SG+P3:SPre+SG+P1:SPre+SG+P3:ImPre+SG+P2
accumule	accumuler	Ver:PPas+Mas+SG
accumulee	accumule	Adj:Fem+SG
accumulee	accumuler	Ver:PPas+Fem+SG
accumulees	accumule	Adj:Fem+PL
accumulees	accumuler	Ver:PPas+Fem+PL
accumulent	accumuler	Ver:IPre+PL+P3:SPre+PL+P3
accumulera	accumuler	Ver:IFut+SG+P3
accumuler	accumuler	Ver:Inf
accumulerai	accumuler	Ver:IFut+SG+P1
accumuleraient	accumuler	Ver:CPre+PL+P3
accumulerais	accumuler	Ver:CPre+SG+P1:CPre+SG+P2
accumulerait	accumuler	Ver:CPre+SG+P3
accumuleras	accumuler	Ver:IFut+SG+P2
accumulerent	accumuler	Ver:IPSim+PL+P3
accumulerez	accumuler	Ver:IFut+PL+P2
accumuleriez	accumuler	Ver:CPre+PL+P2
accumulerions	accumuler	Ver:CPre+PL+P1
accumulerons	accumuler	Ver:IFut+PL+P1
accumuleront	accumuler	Ver:IFut+PL+P3
accumules	accumule	Adj:Mas+PL
accumules	accumuler	Ver:IPre+SG+P2:SPre+SG+P2
accumules	accumuler	Ver:PPas+Mas+PL
accumulez	accumuler	Ver:IPre+PL+P2:ImPre+PL+P2
accumuliez	accumuler	Ver:IImp+PL+P2:SPre+PL+P2
accumulions	accumuler	Ver:IImp+PL+P1:SPre+PL+P1
accumulons	accumuler	Ver:IPre+PL+P1:ImPre+PL+P1
accusa	accuser	Ver:IPSim+SG+P3
accusai	accuser	Ver:IPSim+SG+P1
accusaient	accuser	Ver:IImp+PL+P3
accusais	accuser	Ver:IImp+SG+P1:IImp+SG+P2
accusait	accuser	Ver:IImp+SG+P3
accusames	accuser	Ver:IPSim+PL+P1
accusant	accuser	Ver:PPre
accusas	accuser	Ver:IPSim+SG+P2
accusasse	accuser	Ver:SImp+SG+P1
accusassent	accuser	Ver:SImp+PL+P3
accusasses	accuser	Ver:SImp+SG+P2
accusassiez	accuser	Ver:SImp+PL+P2
accusassions	accuser	Ver:SImp+PL+P1
accusat	accuser	Ver:SImp+SG+P3
accusates	accuser	Ver:IPSim+PL+P2
accusateur	accusateur	Adj:Mas+SG
accusateurs	accusateur	Adj:Mas+PL
accusatif	accusatif	Nom:Mas+SG
accusatifs	accusatif	Nom:Mas+PL
accusation	accusation	Nom:Fem+SG
accusations	accusation	Nom:Fem+PL
accusatoire	accusatoire	Adj:InvGen+SG
accusatrice	accusateur	Adj:Fem+SG
accusatrice	accusateur	Nom:Fem+SG
accusatrices	accusateur	Adj:Fem+PL
accusatrices	accusateur	Nom:Fem+PL
accuse	accuse	Adj:Mas+SG
accuse	accuse	Nom:Mas+SG
accuse	accuser	Ver:IPre+SG+P1:IPre+SG+P3:SPre+SG+P1:SPre+SG+P3:ImPre+SG+P2
accuse	accuser	Ver:PPas+Mas+SG
accusee	accuse	Adj:Fem+SG
accusee	accuse	Nom:Fem+SG
accusee	accuser	Ver:PPas+Fem+SG
accusees	accuse	Adj:Fem+PL
accusees	accuse	Nom:Fem+PL
accusees	accuser	Ver:PPas+Fem+PL
accusent	accuser	Ver:IPre+PL+P3:SPre+PL+P3
accusera	accuser	Ver:IFut+SG+P3
accuser	accuser	Ver:Inf
accuserai	accuser	Ver:IFut+SG+P1
accuseraient	accuser	Ver:CPre+PL+P3
accuserais	accuser	Ver:CPre+SG+P1:CPre+SG+P2
accuserait	accuser	Ver:CPre+SG+P3
accuseras	accuser	Ver:IFut+SG+P2
accuserent	accuser	Ver:IPSim+PL+P3
accuserez	accuser	Ver:IFut+PL+P2
accuseriez	accuser	Ver:CPre+PL+P2
accuserions	accuser	Ver:CPre+PL+P1
accuserons	accuser	Ver:IFut+PL+P1
accuseront	accuser	Ver:IFut+PL+P3
accuses	accuse	Adj:Mas+PL
accuses	accuse	Nom:Mas+PL
accuses	accuser	Ver:IPre+SG+P2:SPre+SG+P2
accuses	accuser	Ver:PPas+Mas+PL
accusez	accuser	Ver:IPre+PL+P2:ImPre+PL+P2
accusiez	accuser	Ver:IImp+PL+P2:SPre+PL+P2
accusions	accuser	Ver:IImp+PL+P1:SPre+PL+P1
accusons	accuser	Ver:IPre+PL+P1:ImPre+PL+P1
ace	ace	Nom:Mas+SG
acensant	acenser	Ver:PPre
acensant	acenser	Ver:PPre+Mas+SG
acense	acenser	Ver:Imp+SG+P2
acense	acenser	Ver:IPre+SG+P1
acense	acenser	Ver:IPre+SG+P3
acense	acenser	Ver:SPre+SG+P1
acense	acenser	Ver:SPre+SG+P3
acenser	acenser	Ver:Inf
acephale	acephale	Adj:InvGen+SG
acephale	acephale	Nom:Mas+SG
acerant	acerer	Ver:PPre
acerbe	acerbe	Adj:InvGen+SG
acerbes	acerbe	Adj:InvGen+PL
acerbite	acerbite	Nom:Fem+SG
acere	acere	Adj:Mas+SG
acere	acerer	Ver:Imp+SG+P2
acere	acerer	Ver:IPre+SG+P1
acere	acerer	Ver:IPre+SG+P3
acere	acerer	Ver:PPas+Mas+SG
acere	acerer	Ver:SPre+SG+P1
acere	acerer	Ver:SPre+SG+P3
aceree	acere	Adj:Fem+SG
aceree	acerer	Ver:PPas+Fem+SG
acerees	acere	Adj:Fem+PL
acerees	acerer	Ver:PPas+Fem+PL
acerent	acerer	Ver:IPre+PL+P3
acerent	acerer	Ver:SPre+PL+P3
acerer	acerer	Ver:Inf
aceres	acere	Adj:Mas+PL
aceres	acerer	Ver:IPre+SG+P2
aceres	acerer	Ver:PPas+Mas+PL
aceres	acerer	Ver:SPre+SG+P2
aces	ace	Nom:Mas+PL
acescence	acescence	Nom:Fem+SG
acescent	acescent	Adj:Mas+SG
acescente	acescent	Adj:Fem+SG
acescentes	acescent	Adj:Fem+PL
acetamide	acetamide	Nom:Mas+SG
acetate	acetate	Nom:Mas+SG
acetates	acetate	Nom:Mas+PL
acetifiant	acetifier	Ver:PPre
acetifiant	acetifier	Ver:PPre+Mas+SG
acetifie	acetifier	Ver:Imp+SG+P2
acetifie	acetifier	Ver:IPre+SG+P1
acetifie	acetifier	Ver:IPre+SG+P3
acetifie	acetifier	Ver:SPre+SG+P1
acetifie	acetifier	Ver:SPre+SG+P3
acetifier	acetifier	Ver:Inf
acetique	acetique	Adj:InvGen+SG
acetobacter	acetobacter	Nom:Mas+SG
acetone	acetone	Nom:Fem+SG
acetonemie	acetonemie	Nom:Fem+SG
acetonurie	acetonurie	Nom:Fem+SG
acetyle	acetyle	Nom:Mas+SG
acetyle	acetyler	Ver:IPre+SG+P1:IPre+SG+P3:SPre+SG+P1:SPre+SG+P3:ImPre+SG+P2
acetylene	acetylene	Nom:Mas+SG
acetylenique	acetylenique	Adj:InvGen+SG
acetylsalicylique	acetylsalicylique	Adj:InvGen+SG
acetylure	acetylure	Nom:Mas+SG
achaine	achaine	Nom:Mas+SG
achalandage	achalandage	Nom:Mas+SG
achalandages	achalandage	Nom:Mas+PL
achalandant	achalander	Ver:PPre
achalande	achalande	Adj:Mas+SG
achalandee	achalande	Adj:Fem+SG
achalandees	achalande	Adj:Fem+PL
achalander	achalander	Ver:Inf
achalandes	achalande	Adj:Mas+PL
achalasie	achalasie	Nom:Fem+SG
achard	achard	Nom:Mas+SG
achards	achard	Nom:Mas+PL
achards	achards	Nom:Mas+PL
acharisme	acharisme	Nom:Mas+SG
acharna	acharner	Ver:IPSim+SG+P3
acharnai	acharner	Ver:IPSim+SG+P1
acharnaient	acharner	Ver:IImp+PL+P3
acharnais	acharner	Ver:IImp+SG+P1:IImp+SG+P2
acharnait	acharner	Ver:IImp+SG+P3
acharnames	acharner	Ver:IPSim+PL+P1
acharnant	acharner	Ver:PPre
acharnas	acharner	Ver:IPSim+SG+P2
acharnasse	acharner	Ver:SImp+SG+P1
acharnassent	acharner	Ver:SImp+PL+P3
acharnasses	acharner	Ver:SImp+SG+P2
acharnassiez	acharner	Ver:SImp+PL+P2
acharnassions	acharner	Ver:SImp+PL+P1
acharnat	acharner	Ver:SImp+SG+P3
acharnates	acharner	Ver:IPSim+PL+P2
acharne	acharne	Adj:Mas+SG
acharne	acharne	Nom:Mas+SG
acharne	acharner	Ver:IPre+SG+P1:IPre+SG+P3:SPre+SG+P1:SPre+SG+P3:ImPre+SG+P2
acharne	acharner	Ver:PPas+Mas+SG
acharnee	acharne	Adj:Fem+SG
acharnee	acharne	Nom:Fem+SG
acharnee	acharner	Ver:PPas+Fem+SG
acharnees	acharne	Adj:Fem+PL
acharnees	acharne	Nom:Fem+PL
acharnees	acharner	Ver:PPas+Fem+PL
acharnement	acharnement	Nom:Mas+SG
acharnements	acharnement	Nom:Mas+PL
acharnent	acharner	Ver:IPre+PL+P3:SPre+PL+P3
acharnera	acharner	Ver:IFut+SG+P3
acharner	acharner	Ver:Inf
acharnerai	acharner	Ver:IFut+SG+P1
acharneraient	acharner	Ver:CPre+PL+P3
acharnerais	acharner	Ver:CPre+SG+P1:CPre+SG+P2
acharnerait	acharner	Ver:CPre+SG+P3
acharneras	acharner	Ver:IFut+SG+P2
acharnerent	acharner	Ver:IPSim+PL+P3
acharnerez	acharner	Ver:IFut+PL+P2
acharneriez	acharner	Ver:CPre+PL+P2
acharnerions	acharner	Ver:CPre+PL+P1
acharnerons	acharner	Ver:IFut+PL+P1
acharneront	acharner	Ver:IFut+PL+P3
acharnes	acharne	Adj:Mas+PL
acharnes	acharne	Nom:Mas+PL
acharnes	acharner	Ver:IPre+SG+P2:SPre+SG+P2
acharnes	acharner	Ver:PPas+Mas+PL
acharnez	acharner	Ver:IPre+PL+P2:ImPre+PL+P2
acharniez	acharner	Ver:IImp+PL+P2:SPre+PL+P2
acharnions	acharner	Ver:IImp+PL+P1:SPre+PL+P1
acharnons	acharner	Ver:IPre+PL+P1:ImPre+PL+P1
achat	achat	Nom:Mas+SG
achats	achat	Nom:Mas+PL
ache	ache	Nom:Fem+SG
acheen	acheen	Adj:Mas+SG
acheen	acheen	Nom:Mas+SG
acheenne	acheen	Adj:Fem+SG
acheenne	acheen	Nom:Fem+SG
acheennes	acheen	Adj:Fem+PL
acheennes	acheen	Nom:Fem+PL
acheens	acheen	Adj:Mas+PL
acheens	acheen	Nom:Mas+PL
achemenide	achemenide	Adj:InvGen+SG
achemenides	achemenide	Adj:InvGen+PL
achemina	acheminer	Ver:IPSim+SG+P3
acheminai	acheminer	Ver:IPSim+SG+P1
acheminaient	acheminer	Ver:IImp+PL+P3
acheminais	acheminer	Ver:IImp+SG+P1:IImp+SG+P2
acheminait	acheminer	Ver:IImp+SG+P3
acheminames	acheminer	Ver:IPSim+PL+P1
acheminant	acheminer	Ver:PPre
acheminas	acheminer	Ver:IPSim+SG+P2
acheminasse	acheminer	Ver:SImp+SG+P1
acheminassent	acheminer	Ver:SImp+PL+P3
acheminasses	acheminer	Ver:SImp+SG+P2
acheminassiez	acheminer	Ver:SImp+PL+P2
acheminassions	acheminer	Ver:SImp+PL+P1
acheminat	acheminer	Ver:SImp+SG+P3
acheminates	acheminer	Ver:IPSim+PL+P2
achemine	acheminer	Ver:IPre+SG+P1:IPre+SG+P3:SPre+SG+P1:SPre+SG+P3:ImPre+SG+P2
achemine	acheminer	Ver:PPas+Mas+SG
acheminee	acheminer	Ver:PPas+Fem+SG
acheminees	acheminer	Ver:PPas+Fem+PL
acheminement	acheminement	Nom:Mas+SG
acheminent	acheminer	Ver:IPre+PL+P3:SPre+PL+P3
acheminera	acheminer	Ver:IFut+SG+P3
acheminer	acheminer	Ver:Inf
acheminerai	acheminer	Ver:IFut+SG+P1
achemineraient	acheminer	Ver:CPre+PL+P3
acheminerais	acheminer	Ver:CPre+SG+P1:CPre+SG+P2
acheminerait	acheminer	Ver:CPre+SG+P3
achemineras	acheminer	Ver:IFut+SG+P2
acheminerent	acheminer	Ver:IPSim+PL+P3
acheminerez	acheminer	Ver:IFut+PL+P2
achemineriez	acheminer	Ver:CPre+PL+P2
acheminerions	acheminer	Ver:CPre+PL+P1
acheminerons	acheminer	Ver:IFut+PL+P1
achemineront	acheminer	Ver:IFut+PL+P3
achemines	acheminer	Ver:IPre+SG+P2:SPre+SG+P2
achemines	acheminer	Ver:PPas+Mas+PL
acheminez	acheminer	Ver:IPre+PL+P2:ImPre+PL+P2
acheminiez	acheminer	Ver:IImp+PL+P2:SPre+PL+P2
acheminions	acheminer	Ver:IImp+PL+P1:SPre+PL+P1
acheminons	acheminer	Ver:IPre+PL+P1:ImPre+PL+P1
acheta	acheter	Ver:IPSim+SG+P3
achetable	achetable	Adj:InvGen+SG
achetables	achetable	Adj:InvGen+PL
achetai	acheter	Ver:IPSim+SG+P1
achetaient	acheter	Ver:IImp+PL+P3
achetais	acheter	Ver:IImp+SG+P1:IImp+SG+P2
achetait	acheter	Ver:IImp+SG+P3
achetames	acheter	Ver:IPSim+PL+P1
achetant	acheter	Ver:PPre
achetant	acheter	Ver:PPre+Mas+SG
achetas	acheter	Ver:IPSim+SG+P2
achetasse	acheter	Ver:SImp+SG+P1
achetassent	acheter	Ver:SImp+PL+P3
achetasses	acheter	Ver:SImp+SG+P2
achetassiez	acheter	Ver:SImp+PL+P2
achetassions	acheter	Ver:SImp+PL+P1
achetat	acheter	Ver:SImp+SG+P3
achetates	acheter	Ver:IPSim+PL+P2
achete	achete	Nom:Mas+SG
achete	acheter	Ver:IPre+SG+P1:IPre+SG+P3:SPre+SG+P1:SPre+SG+P3:ImPre+SG+P2
achete	acheter	Ver:PPas+Mas+SG
achetee	acheter	Ver:PPas+Fem+SG
achetees	acheter	Ver:PPas+Fem+PL
achetent	acheter	Ver:IPre+PL+P3:SPre+PL+P3
achetera	acheter	Ver:IFut+SG+P3
acheter	acheter	Ver:Inf
acheterai	acheter	Ver:IFut+SG+P1
acheteraient	acheter	Ver:CPre+PL+P3
acheterais	acheter	Ver:CPre+SG+P1:CPre+SG+P2
acheterait	acheter	Ver:CPre+SG+P3
acheteras	acheter	Ver:IFut+SG+P2
acheterent	acheter	Ver:IPSim+PL+P3
acheterez	acheter	Ver:IFut+PL+P2
acheteriez	acheter	Ver:CPre+PL+P2
acheterions	acheter	Ver:CPre+PL+P1
acheterons	acheter	Ver:IFut+PL+P1
acheteront	acheter	Ver:IFut+PL+P3
achetes	achete	Nom:Mas+PL
achetes	acheter	Ver:IPre+SG+P2:SPre+SG+P2
achetes	acheter	Ver:PPas+Mas+PL
acheteur	acheteur	Adj:Mas+SG
acheteur	acheteur	Nom:Mas+SG
acheteurs	acheteur	Adj:Mas+PL
acheteurs	acheteur	Nom:Mas+PL
acheteuse	acheteur	Nom:Fem+SG
acheteuses	acheteur	Nom:Fem+PL
achetez	acheter	Ver:IPre+PL+P2:ImPre+PL+P2
achetiez	acheter	Ver:IImp+PL+P2:SPre+PL+P2
achetions	acheter	Ver:IImp+PL+P1:SPre+PL+P1
achetons	acheter	Ver:IPre+PL+P1:ImPre+PL+P1
acheuleen	acheuleen	Adj:Mas+SG
acheuleen	acheuleen	Nom:Mas+SG
acheuleenne	acheuleen	Adj:Fem+SG
acheuleennes	acheuleen	Adj:Fem+PL
acheuleens	acheuleen	Adj:Mas+PL
acheuleens	acheuleen	Nom:Mas+PL
acheva	achever	Ver:IPSim+SG+P3
achevai	achever	Ver:IPSim+SG+P1
achevaient	achever	Ver:IImp+PL+P3
achevais	achever	Ver:IImp+SG+P1:IImp+SG+P2
achevait	achever	Ver:IImp+SG+P3
achevames	achever	Ver:IPSim+PL+P1
achevant	achever	Ver:PPre
achevas	achever	Ver:IPSim+SG+P2
achevasse	achever	Ver:SImp+SG+P1
achevassent	achever	Ver:SImp+PL+P3
achevasses	achever	Ver:SImp+SG+P2
achevassiez	achever	Ver:SImp+PL+P2
achevassions	achever	Ver:SImp+PL+P1
achevat	achever	Ver:SImp+SG+P3
achevates	achever	Ver:IPSim+PL+P2
acheve	acheve	Adj:Mas+SG
acheve	acheve	Nom:Mas+SG
acheve	achever	Ver:IPre+SG+P1:IPre+SG+P3:SPre+SG+P1:SPre+SG+P3:ImPre+SG+P2
acheve	achever	Ver:PPas+Mas+SG
achevee	acheve	Adj:Fem+SG
achevee	achever	Ver:PPas+Fem+SG
achevees	acheve	Adj:Fem+PL
achevees	achever	Ver:PPas+Fem+PL
achevement	achevement	Nom:Mas+SG
achevements	achevement	Nom:Mas+PL
achevent	achever	Ver:IPre+PL+P3:SPre+PL+P3
achevera	achever	Ver:IFut+SG+P3
achever	achever	Ver:Inf
acheverai	achever	Ver:IFut+SG+P1
acheveraient	achever	Ver:CPre+PL+P3
acheverais	achever	Ver:CPre+SG+P1:CPre+SG+P2
acheverait	achever	Ver:CPre+SG+P3
acheveras	achever	Ver:IFut+SG+P2
acheverent	achever	Ver:IPSim+PL+P3
acheverez	achever	Ver:IFut+PL+P2
acheveriez	achever	Ver:CPre+PL+P2
acheverions	achever	Ver:CPre+PL+P1
acheverons	achever	Ver:IFut+PL+P1
acheveront	achever	Ver:IFut+PL+P3
acheves	acheve	Adj:Mas+PL
acheves	acheve	Nom:Mas+PL
acheves	achever	Ver:IPre+SG+P2:SPre+SG+P2
acheves	achever	Ver:PPas+Mas+PL
achevez	achever	Ver:IPre+PL+P2:ImPre+PL+P2
acheviez	achever	Ver:IImp+PL+P2:SPre+PL+P2
achevions	achever	Ver:IImp+PL+P1:SPre+PL+P1
achevons	achever	Ver:IPre+PL+P1:ImPre+PL+P1
achigan	achigan	Nom:Mas+SG
achillee	achillee	Nom:Fem+SG
acholie	acholie	Nom:Fem+SG
achondroplasie	achondroplasie	Nom:Fem+SG
achoppa	achopper	Ver:IPSim+SG+P3
achoppai	achopper	Ver:IPSim+SG+P1
achoppaient	achopper	Ver:IImp+PL+P3
achoppais	achopper	Ver:IImp+SG+P1:IImp+SG+P2
achoppait	achopper	Ver:IImp+SG+P3
achoppames	achopper	Ver:IPSim+PL+P1
achoppant	achopper	Ver:PPre
achoppas	achopper	Ver:IPSim+SG+P2
achoppasse	achopper	Ver:SImp+SG+P1
achoppassent	achopper	Ver:SImp+PL+P3
achoppasses	achopper	Ver:SImp+SG+P2
achoppassiez	achopper	Ver:SImp+PL+P2
achoppassions	achopper	Ver:SImp+PL+P1
achoppat	achopper	Ver:SImp+SG+P3
achoppates	achopper	Ver:IPSim+PL+P2
achoppe	achopper	Ver:IPre+SG+P1:IPre+SG+P3:SPre+SG+P1:SPre+SG+P3:ImPre+SG+P2
achoppe	achopper	Ver:PPas+Mas+SG
achoppement	achoppement	Nom:Mas+SG
achoppent	achopper	Ver:IPre+PL+P3:SPre+PL+P3
achoppera	achopper	Ver:IFut+SG+P3
achopper	achopper	Ver:Inf
achopperai	achopper	Ver:IFut+SG+P1
achopperaient	achopper	Ver:CPre+PL+P3
achopperais	achopper	Ver:CPre+SG+P1:CPre+SG+P2
achopperait	achopper	Ver:CPre+SG+P3
achopperas	achopper	Ver:IFut+SG+P2
achopperent	achopper	Ver:IPSim+PL+P3
achopperez	achopper	Ver:IFut+PL+P2
achopperiez	achopper	Ver:CPre+PL+P2
achopperions	achopper	Ver:CPre+PL+P1
achopperons	achopper	Ver:IFut+PL+P1
achopperont	achopper	Ver:IFut+PL+P3
achoppes	achopper	Ver:IPre+SG+P2:SPre+SG+P2
achoppez	achopper	Ver:IPre+PL+P2:ImPre+PL+P2
achoppiez	achopper	Ver:IImp+PL+P2:SPre+PL+P2
achoppions	achopper	Ver:IImp+PL+P1:SPre+PL+P1
achoppons	achopper	Ver:IPre+PL+P1:ImPre+PL+P1
achromat	achromat	Nom:Mas+SG
achromaticite	achromaticite	Nom:Fem+SG
achromatique	achromatique	Adj:InvGen+SG
achromatisant	achromatiser	Ver:PPre
achromatise	achromatiser	Ver:PPas+Mas+SG
achromatiser	achromatiser	Ver:Inf
achromatisme	achromatisme	Nom:Mas+SG
achromatopsie	achromatopsie	Nom:Fem+SG
achrome	achrome	Adj:InvGen+SG
achromie	achromie	Nom:Fem+SG
achromique	achromique	Adj:InvGen+SG
achylie	achylie	Nom:Fem+SG
aciculaire	aciculaire	Adj:InvGen+SG
acidalie	acidalie	Nom:Fem+SG
acide	acide	Adj:InvGen+SG
acide	acide	Nom:Mas+SG
acides	acide	Adj:InvGen+PL
acides	acide	Nom:Mas+PL
acidifia	acidifier	Ver:IPSim+SG+P3
acidifiable	acidifiable	Adj:InvGen+SG
acidifiai	acidifier	Ver:IPSim+SG+P1
acidifiaient	acidifier	Ver:IImp+PL+P3
acidifiais	acidifier	Ver:IImp+SG+P1:IImp+SG+P2
acidifiait	acidifier	Ver:IImp+SG+P3
acidifiames	acidifier	Ver:IPSim+PL+P1
acidifiant	acidifiant	Adj:Mas+SG
acidifiant	acidifiant	Nom:Mas+SG
acidifiant	acidifier	Ver:PPre
acidifiante	acidifiant	Adj:Fem+SG
acidifiantes	acidifiant	Adj:Fem+PL
acidifias	acidifier	Ver:IPSim+SG+P2
acidifiasse	acidifier	Ver:SImp+SG+P1
acidifiassent	acidifier	Ver:SImp+PL+P3
acidifiasses	acidifier	Ver:SImp+SG+P2
acidifiassiez	acidifier	Ver:SImp+PL+P2
acidifiassions	acidifier	Ver:SImp+PL+P1
acidifiat	acidifier	Ver:SImp+SG+P3
acidifiates	acidifier	Ver:IPSim+PL+P2
acidification	acidification	Nom:Fem+SG
acidifie	acidifier	Ver:IPre+SG+P1:IPre+SG+P3:SPre+SG+P1:SPre+SG+P3:ImPre+SG+P2
acidifie	acidifier	Ver:PPas+Mas+SG
acidifiee	acidifier	Ver:PPas+Fem+SG
acidifiees	acidifier	Ver:PPas+Fem+PL
acidifient	acidifier	Ver:IPre+PL+P3:SPre+PL+P3
acidifiera	acidifier	Ver:IFut+SG+P3
acidifier	acidifier	Ver:Inf
acidifierai	acidifier	Ver:IFut+SG+P1
acidifieraient	acidifier	Ver:CPre+PL+P3
acidifierais	acidifier	Ver:CPre+SG+P1:CPre+SG+P2
acidifierait	acidifier	Ver:CPre+SG+P3
acidifieras	acidifier	Ver:IFut+SG+P2
acidifierent	acidifier	Ver:IPSim+PL+P3
acidifierez	acidifier	Ver:IFut+PL+P2
acidifies	acidifier	Ver:IPre+SG+P2:SPre+SG+P2
acidifiez	acidifier	Ver:IPre+PL+P2:ImPre+PL+P2
acidifiiez	acidifier	Ver:IImp+PL+P2:SPre+PL+P2
acidifiions	acidifier	Ver:IImp+PL+P1:SPre+PL+P1
acidifions	acidifier	Ver:IPre+PL+P1:ImPre+PL+P1
acidimetre	acidimetre	Nom:Mas+SG
acidimetrie	acidimetrie	Nom:Fem+SG
acidite	acidite	Nom:Fem+SG
acidites	acidite	Nom:Fem+PL
acidocetose	acidocetose	Nom:Fem+SG
acidophile	acidophile	Adj:InvGen+SG
acidose	acidose	Nom:Fem+SG
acidulant	aciduler	Ver:PPre
acidulation	acidulation	Nom:Fem+SG
acidulations	acidulation	Nom:Fem+PL
acidule	acidule	Adj:Mas+SG
acidule	aciduler	Ver:PPas+Mas+SG
acidulee	acidule	Adj:Fem+SG
acidulee	aciduler	Ver:PPas+Fem+SG
acidulees	acidule	Adj:Fem+PL
acidulees	aciduler	Ver:PPas+Fem+PL
aciduler	aciduler	Ver:Inf
acidules	acidule	Adj:Mas+PL
acidules	aciduler	Ver:PPas+Mas+PL
acier	acier	Nom:Mas+SG
acierage	acierage	Nom:Mas+SG
acierages	acierage	Nom:Mas+PL
acierant	acierer	Ver:PPre
acieration	acieration	Nom:Fem+SG
acierations	acieration	Nom:Fem+PL
aciere	aciere	Adj:Mas+SG
aciere	acierer	Ver:IPre+SG+P1:IPre+SG+P3:SPre+SG+P1:SPre+SG+P3:ImPre+SG+P2
acierent	acierer	Ver:IPre+PL+P3:SPre+PL+P3
acierer	acierer	Ver:Inf
acieres	acierer	Ver:IPre+SG+P2:SPre+SG+P2
aciereuse	aciereux	Adj:Fem+SG
aciereuses	aciereux	Adj:Fem+PL
aciereux	aciereux	Adj:Mas+InvPL
acierie	acierie	Nom:Fem+SG
acieries	acierie	Nom:Fem+PL
aciers	acier	Nom:Mas+PL
acinesie	acinesie	Nom:Fem+SG
acineuse	acineux	Adj:Fem+SG
acineuses	acineux	Adj:Fem+PL
acineux	acineux	Adj:Mas+InvPL
acinus	acinus	Nom:Mas+InvPL
aclinal	aclinal	Adj:Mas+SG
aclinique	aclinique	Adj:InvGen+SG
acme	acme	Nom:Mas+SG
acmeisme	acmeisme	Nom:Mas+SG
acmeiste	acmeiste	Adj:InvGen+SG
acmite	acmite	Nom:Fem+SG
acne	acne	Nom:Fem+SG
acneique	acneique	Adj:InvGen+SG
acneique	acneique	Nom:InvGen+SG
acnodal	acnodal	Adj:Mas+SG
acolytat	acolytat	Nom:Mas+SG
acolyte	acolyte	Nom:InvGen+SG
acolyte	acolyte	Nom:Mas+SG
acolytes	acolyte	Nom:InvGen+PL
acolytes	acolyte	Nom:Mas+PL
acompte	acompte	Nom:Mas+SG
acomptes	acompte	Nom:Mas+PL
acon	acon	Nom:Mas+SG
aconage	aconage	Nom:Mas+SG
acone	acone	Adj:InvGen+SG
aconier	aconier	Nom:Mas+SG
aconit	aconit	Nom:Mas+SG
aconitine	aconitine	Nom:Fem+SG
acoquina	acoquiner	Ver:IPSim+SG+P3
acoquinai	acoquiner	Ver:IPSim+SG+P1
acoquinaient	acoquiner	Ver:IImp+PL+P3
acoquinais	acoquiner	Ver:IImp+SG+P1:IImp+SG+P2
acoquinait	acoquiner	Ver:IImp+SG+P3
acoquinames	acoquiner	Ver:IPSim+PL+P1
acoquinant	acoquiner	Ver:PPre
acoquinas	acoquiner	Ver:IPSim+SG+P2
acoquinasse	acoquiner	Ver:SImp+SG+P1
acoquinassent	acoquiner	Ver:SImp+PL+P3
acoquinasses	acoquiner	Ver:SImp+SG+P2
acoquinassiez	acoquiner	Ver:SImp+PL+P2
acoquinassions	acoquiner	Ver:SImp+PL+P1
acoquinat	acoquiner	Ver:SImp+SG+P3
acoquinates	acoquiner	Ver:IPSim+PL+P2
acoquine	acoquiner	Ver:IPre+SG+P1:IPre+SG+P3:SPre+SG+P1:SPre+SG+P3:ImPre+SG+P2
acoquine	acoquiner	Ver:PPas+Mas+SG
acoquinee	acoquiner	Ver:PPas+Fem+SG
acoquinees	acoquiner	Ver:PPas+Fem+PL
acoquinement	acoquinement	Nom:Mas+SG
acoquinent	acoquiner	Ver:IPre+PL+P3:SPre+PL+P3
acoquinera	acoquiner	Ver:IFut+SG+P3
acoquiner	acoquiner	Ver:Inf
acoquinerai	acoquiner	Ver:IFut+SG+P1
acoquineraient	acoquiner	Ver:CPre+PL+P3
acoquinerais	acoquiner	Ver:CPre+SG+P1:CPre+SG+P2
acoquinerait	acoquiner	Ver:CPre+SG+P3
acoquineras	acoquiner	Ver:IFut+SG+P2
acoquinerent	acoquiner	Ver:IPSim+PL+P3
acoquinerez	acoquiner	Ver:IFut+PL+P2
acoquineriez	acoquiner	Ver:CPre+PL+P2
acoquinerions	acoquiner	Ver:CPre+PL+P1
acoquinerons	acoquiner	Ver:IFut+PL+P1
acoquineront	acoquiner	Ver:IFut+PL+P3
acoquines	acoquiner	Ver:IPre+SG+P2:SPre+SG+P2
acoquinez	acoquiner	Ver:IPre+PL+P2:ImPre+PL+P2
acoquiniez	acoquiner	Ver:IImp+PL+P2:SPre+PL+P2
acoquinions	acoquiner	Ver:IImp+PL+P1:SPre+PL+P1
acoquinons	acoquiner	Ver:IPre+PL+P1:ImPre+PL+P1
acore	acore	Nom:Mas+SG
acotyledone	acotyledone	Adj:InvGen+SG
acotyledone	acotyledone	Nom:Fem+SG
acoumetre	acoumetre	Nom:Mas+SG
acoumetrie	acoumetrie	Nom:Fem+SG
acouphene	acouphene	Nom:Mas+SG
acousticien	acousticien	Nom:Mas+SG
acousticienne	acousticien	Nom:Fem+SG
acousticiennes	acousticien	Nom:Fem+PL
acoustique	acoustique	Adj:InvGen+SG
acoustiques	acoustique	Adj:InvGen+PL
acoustiques	acoustique	Nom:Fem+PL
acqueraient	acquerir	Ver:IImp+PL+P3
acquerais	acquerir	Ver:IImp+SG+P1:IImp+SG+P2
acquerait	acquerir	Ver:IImp+SG+P3
acquerant	acquerir	Ver:PPre
acquereur	acquereur	Nom:Mas+SG
acquereurs	acquereur	Nom:Mas+PL
acquerez	acquerir	Ver:IPre+PL+P2:ImPre+PL+P2
acqueriez	acquerir	Ver:IImp+PL+P2:SPre+PL+P2
acquerions	acquerir	Ver:IImp+PL+P1:SPre+PL+P1
acquerir	acquerir	Ver:Inf
acquerons	acquerir	Ver:IPre+PL+P1:ImPre+PL+P1
acquerra	acquerir	Ver:IFut+SG+P3
acquerrai	acquerir	Ver:IFut+SG+P1
acquerraient	acquerir	Ver:CPre+PL+P3
acquerrais	acquerir	Ver:CPre+SG+P1:CPre+SG+P2
acquerrait	acquerir	Ver:CPre+SG+P3
acquerras	acquerir	Ver:IFut+SG+P2
acquerrez	acquerir	Ver:IFut+PL+P2
acquerriez	acquerir	Ver:CPre+PL+P2
acquerrions	acquerir	Ver:CPre+PL+P1
acquerrons	acquerir	Ver:IFut+PL+P1
acquerront	acquerir	Ver:IFut+PL+P3
acquet	acquet	Nom:Mas+SG
acquets	acquet	Nom:Mas+PL
acquiere	acquerir	Ver:SPre+SG+P1:SPre+SG+P3
acquierent	acquerir	Ver:IPre+PL+P3:SPre+PL+P3
acquieres	acquerir	Ver:SPre+SG+P2
acquiers	acquerir	Ver:IPre+SG+P1:IPre+SG+P2:ImPre+SG+P2
acquiert	acquerir	Ver:IPre+SG+P3
acquiesca	acquiescer	Ver:IPSim+SG+P3
acquiescai	acquiescer	Ver:IPSim+SG+P1
acquiescaient	acquiescer	Ver:IImp+PL+P3
acquiescais	acquiescer	Ver:IImp+SG+P1:IImp+SG+P2
acquiescait	acquiescer	Ver:IImp+SG+P3
acquiescames	acquiescer	Ver:IPSim+PL+P1
acquiescant	acquiescer	Ver:PPre
acquiescas	acquiescer	Ver:IPSim+SG+P2
acquiescasse	acquiescer	Ver:SImp+SG+P1
acquiescassent	acquiescer	Ver:SImp+PL+P3
acquiescasses	acquiescer	Ver:SImp+SG+P2
acquiescassiez	acquiescer	Ver:SImp+PL+P2
acquiescassions	acquiescer	Ver:SImp+PL+P1
acquiescat	acquiescer	Ver:SImp+SG+P3
acquiescates	acquiescer	Ver:IPSim+PL+P2
acquiesce	acquiescer	Ver:IPre+SG+P1:IPre+SG+P3:SPre+SG+P1:SPre+SG+P3:ImPre+SG+P2
acquiesce	acquiescer	Ver:PPas+Mas+SG
acquiescement	acquiescement	Nom:Mas+SG
acquiescent	acquiescer	Ver:IPre+PL+P3:SPre+PL+P3
acquiescera	acquiescer	Ver:IFut+SG+P3
acquiescer	acquiescer	Ver:Inf
acquiescerai	acquiescer	Ver:IFut+SG+P1
acquiesceraient	acquiescer	Ver:CPre+PL+P3
acquiescerais	acquiescer	Ver:CPre+SG+P1:CPre+SG+P2
acquiescerait	acquiescer	Ver:CPre+SG+P3
acquiesceras	acquiescer	Ver:IFut+SG+P2
acquiescerent	acquiescer	Ver:IPSim+PL+P3
acquiescerez	acquiescer	Ver:IFut+PL+P2
acquiesceriez	acquiescer	Ver:CPre+PL+P2
acquiescerions	acquiescer	Ver:CPre+PL+P1
acquiescerons	acquiescer	Ver:IFut+PL+P1
acquiesceront	acquiescer	Ver:IFut+PL+P3
acquiesces	acquiescer	Ver:IPre+SG+P2:SPre+SG+P2
acquiescez	acquiescer	Ver:IPre+PL+P2:ImPre+PL+P2
acquiesciez	acquiescer	Ver:IImp+PL+P2:SPre+PL+P2
acquiescions	acquiescer	Ver:IImp+PL+P1:SPre+PL+P1
acquiescons	acquiescer	Ver:IPre+PL+P1:ImPre+PL+P1
acquimes	acquerir	Ver:IPSim+PL+P1
acquirent	acquerir	Ver:IPSim+PL+P3
acquis	acquerir	Ver:PPas+Mas+SG:PPas+Mas+PL:IPSim+SG+P1:IPSim+SG+P2
acquis	acquis	Adj:Mas+InvPL
acquis	acquis	Nom:Mas+InvPL
acquise	acquerir	Ver:PPas+Fem+SG
acquise	acquis	Adj:Fem+SG
acquises	acquerir	Ver:PPas+Fem+PL
acquises	acquis	Adj:Fem+PL
acquisitif	acquisitif	Adj:Mas+SG
acquisition	acquisition	Nom:Fem+SG
acquisitions	acquisition	Nom:Fem+PL
acquisitive	acquisitif	Adj:Fem+SG
acquisitives	acquisitif	Adj:Fem+PL
acquisse	acquerir	Ver:SImp+SG+P1
acquissent	acquerir	Ver:SImp+PL+P3
acquisses	acquerir	Ver:SImp+SG+P2
acquissiez	acquerir	Ver:SImp+PL+P2
acquissions	acquerir	Ver:SImp+PL+P1
acquit	acquerir	Ver:IPSim+SG+P3
acquit	acquerir	Ver:SImp+SG+P3
acquit	acquit	Nom:Mas+SG
acquites	acquerir	Ver:IPSim+PL+P2
acquits	acquit	Nom:Mas+PL
acquitta	acquitter	Ver:IPSim+SG+P3
acquittable	acquittable	Adj:InvGen+SG
acquittai	acquitter	Ver:IPSim+SG+P1
acquittaient	acquitter	Ver:IImp+PL+P3
acquittais	acquitter	Ver:IImp+SG+P1:IImp+SG+P2
acquittait	acquitter	Ver:IImp+SG+P3
acquittames	acquitter	Ver:IPSim+PL+P1
acquittant	acquitter	Ver:PPre
acquittas	acquitter	Ver:IPSim+SG+P2
acquittasse	acquitter	Ver:SImp+SG+P1
acquittassent	acquitter	Ver:SImp+PL+P3
acquittasses	acquitter	Ver:SImp+SG+P2
acquittassiez	acquitter	Ver:SImp+PL+P2
acquittassions	acquitter	Ver:SImp+PL+P1
acquittat	acquitter	Ver:SImp+SG+P3
acquittates	acquitter	Ver:IPSim+PL+P2
acquitte	acquitte	Adj:Mas+SG
acquitte	acquitte	Nom:Mas+SG
acquitte	acquitter	Ver:Imp+SG+P2
acquitte	acquitter	Ver:IPre+SG+P1
acquitte	acquitter	Ver:IPre+SG+P3
acquitte	acquitter	Ver:PPas+Mas+SG
acquitte	acquitter	Ver:SPre+SG+P1
acquitte	acquitter	Ver:SPre+SG+P3
acquittee	acquitte	Adj:Fem+SG
acquittee	acquitte	Nom:Fem+SG
acquittee	acquitter	Ver:PPas+Fem+SG
acquittees	acquitte	Adj:Fem+PL
acquittees	acquitte	Nom:Fem+PL
acquittees	acquitter	Ver:PPas+Fem+PL
acquittement	acquittement	Nom:Mas+SG
acquittements	acquittement	Nom:Mas+PL
acquittent	acquitter	Ver:IPre+PL+P3
acquittent	acquitter	Ver:SPre+PL+P3
acquittera	acquitter	Ver:IFut+SG+P3
acquitter	acquitter	Ver:Inf
acquitterai	acquitter	Ver:IFut+SG+P1
acquitteraient	acquitter	Ver:CPre+PL+P3
acquitterais	acquitter	Ver:CPre+SG+P1:CPre+SG+P2
acquitterait	acquitter	Ver:CPre+SG+P3
acquitteras	acquitter	Ver:IFut+SG+P2
acquitterent	acquitter	Ver:IPSim+PL+P3
acquitterez	acquitter	Ver:IFut+PL+P2
acquitteriez	acquitter	Ver:CPre+PL+P2
acquitterions	acquitter	Ver:CPre+PL+P1
acquitterons	acquitter	Ver:IFut+PL+P1
acquitteront	acquitter	Ver:IFut+PL+P3
acquittes	acquitte	Adj:Mas+PL
acquittes	acquitte	Nom:Mas+PL
acquittes	acquitter	Ver:IPre+SG+P2
acquittes	acquitter	Ver:PPas+Mas+PL
acquittes	acquitter	Ver:SPre+SG+P2
acquittez	acquitter	Ver:IPre+PL+P2:ImPre+PL+P2
acquittiez	acquitter	Ver:IImp+PL+P2:SPre+PL+P2
acquittions	acquitter	Ver:IImp+PL+P1:SPre+PL+P1
acquittons	acquitter	Ver:IPre+PL+P1:ImPre+PL+P1
acre	acre	Adj:InvGen+SG
acre	acre	Nom:Fem+SG
acre	acre	Nom:Mas+SG
acrement	acrement	Adv
acres	acre	Adj:InvGen+PL
acres	acre	Nom:Fem+PL
acres	acre	Nom:Mas+PL
acrete	acrete	Nom:Fem+SG
acridien	acridien	Adj:Mas+SG
acridien	acridien	Nom:Mas+SG
acridiens	acridien	Adj:Mas+PL
acridiens	acridien	Nom:Mas+PL
acrimonie	acrimonie	Nom:Fem+SG
acrimonieuse	acrimonieux	Adj:Fem+SG
acrimonieusement	acrimonieusement	Adv
acrimonieuses	acrimonieux	Adj:Fem+PL
acrimonieux	acrimonieux	Adj:Mas+InvPL
acrobate	acrobate	Nom:InvGen+SG
acrobate	acrobate	Nom:Mas+SG
acrobates	acrobate	Nom:InvGen+PL
acrobates	acrobate	Nom:Mas+PL
acrobatie	acrobatie	Nom:Fem+SG
acrobaties	acrobatie	Nom:Fem+PL
acrobatique	acrobatique	Adj:InvGen+SG
acrobatiquement	acrobatiquement	Adv
acrobatiques	acrobatique	Adj:InvGen+PL
acrocephale	acrocephale	Adj:InvGen+SG
acrocephale	acrocephale	Nom:InvGen+SG
acrocephalie	acrocephalie	Nom:Fem+SG
acrocyanose	acrocyanose	Nom:Fem+SG
acrodynie	acrodynie	Nom:Fem+SG
acroleine	acroleine	Nom:Fem+SG
acrolithe	acrolithe	Adj:InvGen+SG
acromegale	acromegale	Adj:InvGen+SG
acromegalie	acromegalie	Nom:Fem+SG
acromegalique	acromegalique	Adj:InvGen+SG
acromion	acromion	Nom:Mas+SG
acron	acron	Nom:Mas+SG
acronyme	acronyme	Nom:Mas+SG
acrophobie	acrophobie	Nom:Fem+SG
acropole	acropole	Nom:Fem+SG
acrostiche	acrostiche	Adj:InvGen+SG
acrostiche	acrostiche	Nom:Mas+SG
acrotere	acrotere	Nom:Mas+SG
acrylique	acrylique	Adj:InvGen+SG
acryliques	acrylique	Adj:InvGen+PL
acryliques	acrylique	Nom:Mas+PL
actant	actant	Nom:Mas+SG
actant	acter	Ver:PPre
acte	acte	Nom:Mas+SG
acte	acter	Ver:IPre+SG+P1:IPre+SG+P3:SPre+SG+P1:SPre+SG+P3:ImPre+SG+P2
actee	actee	Nom:Fem+SG
actee	acter	Ver:PPas+Fem+SG
actes	acte	Nom:Mas+PL
actes	acter	Ver:IPre+SG+P2:SPre+SG+P2
actes	actes	Nom:Mas+PL
acteur	acteur	Nom:Mas+SG
acteurs	acteur	Nom:Mas+PL
actif	actif	Adj:Mas+SG
actifs	actif	Adj:Mas+PL
actifs	actif	Nom:Mas+PL
actifs	actifs	Nom:Mas+PL
actine	actine	Nom:Fem+SG
acting	acting	Nom:Mas+SG
actiniaire	actiniaire	Nom:Mas+SG
actinide	actinide	Nom:Mas+SG
actinie	actinie	Nom:Fem+SG
actinique	actinique	Adj:InvGen+SG
actinisme	actinisme	Nom:Mas+SG
actinite	actinite	Nom:Fem+SG
actinium	actinium	Nom:Mas+SG
actinologie	actinologie	Nom:Fem+SG
actinometre	actinometre	Nom:Mas+SG
actinometrie	actinometrie	Nom:Fem+SG
actinometrique	actinometrique	Adj:InvGen+SG
actinomycete	actinomycete	Nom:Mas+SG
actinomycine	actinomycine	Nom:Fem+SG
actinomycose	actinomycose	Nom:Fem+SG
actinopode	actinopode	Nom:Mas+SG
actinoscopie	actinoscopie	Nom:Fem+SG
actinote	actinote	Nom:Fem+SG
actinotherapie	actinotherapie	Nom:Fem+SG
action	action	Nom:Fem+SG
actionna	actionner	Ver:IPSim+SG+P3
actionnable	actionnable	Adj:InvGen+SG
actionnai	actionner	Ver:IPSim+SG+P1
actionnaient	actionner	Ver:IImp+PL+P3
actionnaire	actionnaire	Nom:InvGen+SG
actionnaires	actionnaire	Nom:InvGen+PL
actionnais	actionner	Ver:IImp+SG+P1
actionnais	actionner	Ver:IImp+SG+P2
actionnait	actionner	Ver:IImp+SG+P3
actionnalisme	actionnalisme	Nom:Mas+SG
actionnaliste	actionnaliste	Adj:InvGen+SG
actionnames	actionner	Ver:IPSim+PL+P1
actionnant	actionner	Ver:PPre
actionnariat	actionnariat	Nom:Mas+SG
actionnas	actionner	Ver:IPSim+SG+P2
actionnasse	actionner	Ver:SImp+SG+P1
actionnassent	actionner	Ver:SImp+PL+P3
actionnasses	actionner	Ver:SImp+SG+P2
actionnassiez	actionner	Ver:SImp+PL+P2
actionnassions	actionner	Ver:SImp+PL+P1
actionnat	actionner	Ver:SImp+SG+P3
actionnates	actionner	Ver:IPSim+PL+P2
actionne	actionner	Ver:IPre+SG+P1:IPre+SG+P3:SPre+SG+P1:SPre+SG+P3:ImPre+SG+P2
actionne	actionner	Ver:PPas+Mas+SG
actionnee	actionner	Ver:PPas+Fem+SG
actionnees	actionner	Ver:PPas+Fem+PL
actionnement	actionnement	Nom:Mas+SG
actionnent	actionner	Ver:IPre+PL+P3:SPre+PL+P3
actionnera	actionner	Ver:IFut+SG+P3
actionner	actionner	Ver:Inf
actionnerai	actionner	Ver:IFut+SG+P1
actionneraient	actionner	Ver:CPre+PL+P3
actionnerais	actionner	Ver:CPre+SG+P1:CPre+SG+P2
actionnerait	actionner	Ver:CPre+SG+P3
actionneras	actionner	Ver:IFut+SG+P2
actionnerent	actionner	Ver:IPSim+PL+P3
actionnerez	actionner	Ver:IFut+PL+P2
actionneriez	actionner	Ver:CPre+PL+P2
actionnerions	actionner	Ver:CPre+PL+P1
actionnerons	actionner	Ver:IFut+PL+P1
actionneront	actionner	Ver:IFut+PL+P3
actionnes	actionner	Ver:IPre+SG+P2:SPre+SG+P2
actionnes	actionner	Ver:PPas+Mas+PL
actionneur	actionneur	Nom:Mas+SG
actionneurs	actionneur	Nom:Mas+PL
actionnez	actionner	Ver:IPre+PL+P2:ImPre+PL+P2
actionniez	actionner	Ver:IImp+PL+P2:SPre+PL+P2
actionnions	actionner	Ver:IImp+PL+P1
actionnions	actionner	Ver:SPre+PL+P1
actionnons	actionner	Ver:IPre+PL+P1:ImPre+PL+P1
actions	acter	Ver:IImp+PL+P1:SPre+PL+P1
actions	action	Nom:Fem+PL
activa	activer	Ver:IPSim+SG+P3
activai	activer	Ver:IPSim+SG+P1
activaient	activer	Ver:IImp+PL+P3
activais	activer	Ver:IImp+SG+P1:IImp+SG+P2
activait	activer	Ver:IImp+SG+P3
activames	activer	Ver:IPSim+PL+P1
activant	activant	Nom:Mas+SG
activant	activer	Ver:PPre
activas	activer	Ver:IPSim+SG+P2
activasse	activer	Ver:SImp+SG+P1
activassent	activer	Ver:SImp+PL+P3
activasses	activer	Ver:SImp+SG+P2
activassiez	activer	Ver:SImp+PL+P2
activassions	activer	Ver:SImp+PL+P1
activat	activer	Ver:SImp+SG+P3
activates	activer	Ver:IPSim+PL+P2
activateur	activateur	Adj:Mas+SG
activateur	activateur	Nom:Mas+SG
activation	activation	Nom:Fem+SG
activations	activation	Nom:Fem+PL
activatrice	activateur	Adj:Fem+SG
active	actif	Adj:Fem+SG
active	actif	Nom:Fem+SG
active	active	Adj:Mas+SG
active	active	Nom:Fem+SG
active	activer	Ver:IPre+SG+P1:IPre+SG+P3:SPre+SG+P1:SPre+SG+P3:ImPre+SG+P2
active	activer	Ver:PPas+Mas+SG
activee	active	Adj:Fem+SG
activee	activer	Ver:PPas+Fem+SG
activees	active	Adj:Fem+PL
activees	activer	Ver:PPas+Fem+PL
activement	activement	Adv
activent	activer	Ver:IPre+PL+P3:SPre+PL+P3
activera	activer	Ver:IFut+SG+P3
activer	activer	Ver:Inf
activerai	activer	Ver:IFut+SG+P1
activeraient	activer	Ver:CPre+PL+P3
activerais	activer	Ver:CPre+SG+P1:CPre+SG+P2
activerait	activer	Ver:CPre+SG+P3
activeras	activer	Ver:IFut+SG+P2
activerent	activer	Ver:IPSim+PL+P3
activerez	activer	Ver:IFut+PL+P2
activeriez	activer	Ver:CPre+PL+P2
activerions	activer	Ver:CPre+PL+P1
activerons	activer	Ver:IFut+PL+P1
activeront	activer	Ver:IFut+PL+P3
actives	actif	Adj:Fem+PL
actives	actif	Nom:Fem+PL
actives	active	Adj:Mas+PL
actives	activer	Ver:IPre+SG+P2:SPre+SG+P2
actives	activer	Ver:PPas+Mas+PL
activeur	activeur	Nom:Mas+SG
activez	activer	Ver:IPre+PL+P2:ImPre+PL+P2
activiez	activer	Ver:IImp+PL+P2:SPre+PL+P2
activions	activer	Ver:IImp+PL+P1:SPre+PL+P1
activisme	activisme	Nom:Mas+SG
activiste	activiste	Adj:InvGen+SG
activiste	activiste	Nom:InvGen+SG
activistes	activiste	Adj:InvGen+PL
activistes	activiste	Nom:InvGen+PL
activite	activite	Nom:Fem+SG
activites	activite	Nom:Fem+PL
activons	activer	Ver:IPre+PL+P1:ImPre+PL+P1
actrice	acteur	Nom:Fem+SG
actrices	acteur	Nom:Fem+PL
actuaire	actuaire	Nom:InvGen+SG
actuaires	actuaire	Nom:InvGen+PL
actualisa	actualiser	Ver:IPSim+SG+P3
actualisai	actualiser	Ver:IPSim+SG+P1
actualisaient	actualiser	Ver:IImp+PL+P3
actualisais	actualiser	Ver:IImp+SG+P1
actualisais	actualiser	Ver:IImp+SG+P2
actualisait	actualiser	Ver:IImp+SG+P3
actualisames	actualiser	Ver:IPSim+PL+P1
actualisant	actualiser	Ver:PPre
actualisas	actualiser	Ver:IPSim+SG+P2
actualisasse	actualiser	Ver:SImp+SG+P1
actualisassent	actualiser	Ver:SImp+PL+P3
actualisasses	actualiser	Ver:SImp+SG+P2
actualisassiez	actualiser	Ver:SImp+PL+P2
actualisassions	actualiser	Ver:SImp+PL+P1
actualisat	actualiser	Ver:SImp+SG+P3
actualisates	actualiser	Ver:IPSim+PL+P2
actualisation	actualisation	Nom:Fem+SG
actualisations	actualisation	Nom:Fem+PL
actualise	actualiser	Ver:IPre+SG+P1:IPre+SG+P3:SPre+SG+P1:SPre+SG+P3:ImPre+SG+P2
actualise	actualiser	Ver:PPas+Mas+SG
actualisee	actualiser	Ver:PPas+Fem+SG
actualisees	actualiser	Ver:PPas+Fem+PL
actualisent	actualiser	Ver:IPre+PL+P3:SPre+PL+P3
actualisera	actualiser	Ver:IFut+SG+P3
actualiser	actualiser	Ver:Inf
actualiserai	actualiser	Ver:IFut+SG+P1
actualiseraient	actualiser	Ver:CPre+PL+P3
actualiserais	actualiser	Ver:CPre+SG+P1:CPre+SG+P2
actualiserait	actualiser	Ver:CPre+SG+P3
actualiseras	actualiser	Ver:IFut+SG+P2
actualiserent	actualiser	Ver:IPSim+PL+P3
actualiserez	actualiser	Ver:IFut+PL+P2
actualiseriez	actualiser	Ver:CPre+PL+P2
actualiserions	actualiser	Ver:CPre+PL+P1
actualiserons	actualiser	Ver:IFut+PL+P1
actualiseront	actualiser	Ver:IFut+PL+P3
actualises	actualiser	Ver:IPre+SG+P2:SPre+SG+P2
actualises	actualiser	Ver:PPas+Mas+PL
actualisez	actualiser	Ver:IPre+PL+P2:ImPre+PL+P2
actualisiez	actualiser	Ver:IImp+PL+P2
actualisiez	actualiser	Ver:SPre+PL+P2
actualisions	actualiser	Ver:IImp+PL+P1
actualisions	actualiser	Ver:SPre+PL+P1
actualisons	actualiser	Ver:IPre+PL+P1:ImPre+PL+P1
actualite	actualite	Nom:Fem+SG
actualites	actualite	Nom:Fem+PL
actualites	actualites	Nom:Fem+PL
actuariat	actuariat	Nom:Mas+SG
actuariel	actuariel	Adj:Mas+SG
actuarielle	actuariel	Adj:Fem+SG
actuarielles	actuariel	Adj:Fem+PL
actuariels	actuariel	Adj:Mas+PL
actuateur	actuateur	Nom:Mas+SG
actuel	actuel	Adj:Mas+SG
actuelle	actuel	Adj:Fem+SG
actuellement	actuellement	Adv
actuelles	actuel	Adj:Fem+PL
actuels	actuel	Adj:Mas+PL
acuite	acuite	Nom:Fem+SG
acuites	acuite	Nom:Fem+PL
aculeate	aculeate	Nom:Mas+SG
aculeates	aculeate	Nom:Mas+PL
aculeiforme	aculeiforme	Adj:InvGen+SG
acumine	acumine	Adj:Mas+SG
acuminee	acumine	Adj:Fem+SG
acuminees	acumine	Adj:Fem+PL
acuponcteur	acuponcteur	Nom:Mas+SG
acuponcteurs	acuponcteur	Nom:Mas+PL
acuponctrice	acuponcteur	Nom:Fem+SG
acuponctrices	acuponcteur	Nom:Fem+PL
acuponcture	acuponcture	Nom:Fem+SG
acupuncteur	acupuncteur	Nom:Mas+SG
acupuncteurs	acupuncteur	Nom:Mas+PL
acupunctrice	acupuncteur	Nom:Fem+SG
acupunctrices	acupuncteur	Nom:Fem+PL
acupuncture	acupuncture	Nom:Fem+SG
acupuncture	acupuncturer	Ver:IPre+SG+P1:IPre+SG+P3:SPre+SG+P1:SPre+SG+P3:ImPre+SG+P2
acutangle	acutangle	Adj:InvGen+SG
acyclique	acyclique	Adj:InvGen+SG
acyle	acyle	Nom:Mas+SG
acyle	acyler	Ver:IPre+SG+P1:IPre+SG+P3:SPre+SG+P1:SPre+SG+P3:ImPre+SG+P2
acyler	acyler	Ver:Inf
acylium	acylium	Nom:Mas+InvPL
adage	adage	Nom:Mas+SG
adages	adage	Nom:Mas+PL
adagio	adagio	Adv
adagio	adagio	Nom:Mas+SG
adagios	adagio	Nom:Mas+PL
adamantin	adamantin	Adj:Mas+SG
adamantine	adamantin	Adj:Fem+SG
adamantines	adamantin	Adj:Fem+PL
adamien	adamien	Adj:Mas+SG
adamien	adamien	Nom:Mas+SG
adamique	adamique	Adj:InvGen+SG
adamisme	adamisme	Nom:Mas+SG
adamite	adamite	Adj:InvGen+SG
adamite	adamite	Nom:Fem+SG
adamite	adamite	Nom:InvGen+SG
adapta	adapter	Ver:IPSim+SG+P3
adaptabilite	adaptabilite	Nom:Fem+SG
adaptabilites	adaptabilite	Nom:Fem+PL
adaptable	adaptable	Adj:InvGen+SG
adaptables	adaptable	Adj:InvGen+PL
adaptai	adapter	Ver:IPSim+SG+P1
adaptaient	adapter	Ver:IImp+PL+P3
adaptais	adapter	Ver:IImp+SG+P1:IImp+SG+P2
adaptait	adapter	Ver:IImp+SG+P3
adaptames	adapter	Ver:IPSim+PL+P1
adaptant	adapter	Ver:PPre
adaptas	adapter	Ver:IPSim+SG+P2
adaptasse	adapter	Ver:SImp+SG+P1
adaptassent	adapter	Ver:SImp+PL+P3
adaptasses	adapter	Ver:SImp+SG+P2
adaptassiez	adapter	Ver:SImp+PL+P2
adaptassions	adapter	Ver:SImp+PL+P1
adaptat	adapter	Ver:SImp+SG+P3
adaptates	adapter	Ver:IPSim+PL+P2
adaptateur	adaptateur	Nom:Mas+SG
adaptateurs	adaptateur	Nom:Mas+PL
adaptatif	adaptatif	Adj:Mas+SG
adaptatifs	adaptatif	Adj:Mas+PL
adaptation	adaptation	Nom:Fem+SG
adaptations	adaptation	Nom:Fem+PL
adaptative	adaptatif	Adj:Fem+SG
adaptatives	adaptatif	Adj:Fem+PL
adaptatrice	adaptateur	Nom:Fem+SG
adaptatrices	adaptateur	Nom:Fem+PL
adapte	adapte	Adj:Mas+SG
adapte	adapter	Ver:IPre+SG+P1:IPre+SG+P3:SPre+SG+P1:SPre+SG+P3:ImPre+SG+P2
adapte	adapter	Ver:PPas+Mas+SG
adaptee	adapter	Ver:PPas+Fem+SG
adaptees	adapter	Ver:PPas+Fem+PL
adaptent	adapter	Ver:IPre+PL+P3:SPre+PL+P3
adaptera	adapter	Ver:IFut+SG+P3
adapter	adapter	Ver:Inf
adapterai	adapter	Ver:IFut+SG+P1
adapteraient	adapter	Ver:CPre+PL+P3
adapterais	adapter	Ver:CPre+SG+P1:CPre+SG+P2
adapterait	adapter	Ver:CPre+SG+P3
adapteras	adapter	Ver:IFut+SG+P2
adapterent	adapter	Ver:IPSim+PL+P3
adapterez	adapter	Ver:IFut+PL+P2
adapteriez	adapter	Ver:CPre+PL+P2
adapterions	adapter	Ver:CPre+PL+P1
adapterons	adapter	Ver:IFut+PL+P1
adapteront	adapter	Ver:IFut+PL+P3
adaptes	adapter	Ver:IPre+SG+P2:SPre+SG+P2
adaptes	adapter	Ver:PPas+Mas+PL
adaptez	adapter	Ver:Imp+PL+P2
adaptez	adapter	Ver:IPre+PL+P2
adaptiez	adapter	Ver:IImp+PL+P2:SPre+PL+P2
adaptions	adapter	Ver:IImp+PL+P1:SPre+PL+P1
adaptons	adapter	Ver:Imp+PL+P1
adaptons	adapter	Ver:IPre+PL+P1
addax	addax	Nom:Mas+InvPL
addenda	addenda	Nom:Mas+InvPL
addict	addict	Nom:InvGen+SG
addiction	addiction	Nom:Fem+SG
additif	additif	Adj:Mas+SG
additif	additif	Nom:Mas+SG
additifs	additif	Adj:Mas+PL
additifs	additif	Nom:Mas+PL
addition	addition	Nom:Fem+SG
additionna	additionner	Ver:IPSim+SG+P3
additionnable	additionnable	Adj:InvGen+SG
additionnai	additionner	Ver:IPSim+SG+P1
additionnaient	additionner	Ver:IImp+PL+P3
additionnais	additionner	Ver:IImp+SG+P1:IImp+SG+P2
additionnait	additionner	Ver:IImp+SG+P3
additionnames	additionner	Ver:IPSim+PL+P1
additionnant	additionner	Ver:PPre
additionnant	additionner	Ver:PPre+Mas+SG
additionnas	additionner	Ver:IPSim+SG+P2
additionnasse	additionner	Ver:SImp+SG+P1
additionnassent	additionner	Ver:SImp+PL+P3
additionnasses	additionner	Ver:SImp+SG+P2
additionnassiez	additionner	Ver:SImp+PL+P2
additionnassions	additionner	Ver:SImp+PL+P1
additionnat	additionner	Ver:SImp+SG+P3
additionnates	additionner	Ver:IPSim+PL+P2
additionne	additionne	Adj:Mas+SG
additionne	additionner	Ver:IPre+SG+P1:IPre+SG+P3:SPre+SG+P1:SPre+SG+P3:ImPre+SG+P2
additionnee	additionne	Adj:Fem+SG
additionnee	additionner	Ver:PPas+Fem+SG
additionnees	additionne	Adj:Fem+PL
additionnees	additionner	Ver:PPas+Fem+PL
additionnel	additionnel	Adj:Mas+SG
additionnelle	additionnel	Adj:Fem+SG
additionnelles	additionnel	Adj:Fem+PL
additionnels	additionnel	Adj:Mas+PL
additionnent	additionner	Ver:IPre+PL+P3:SPre+PL+P3
additionnera	additionner	Ver:IFut+SG+P3
additionner	additionner	Ver:Inf
additionnerai	additionner	Ver:IFut+SG+P1
additionneraient	additionner	Ver:CPre+PL+P3
additionnerais	additionner	Ver:CPre+SG+P1:CPre+SG+P2
additionnerait	additionner	Ver:CPre+SG+P3
additionneras	additionner	Ver:IFut+SG+P2
additionnerent	additionner	Ver:IPSim+PL+P3
additionnerez	additionner	Ver:IFut+PL+P2
additionneriez	additionner	Ver:CPre+PL+P2
additionnerions	additionner	Ver:CPre+PL+P1
additionnerons	additionner	Ver:IFut+PL+P1
additionneront	additionner	Ver:IFut+PL+P3
additionnes	additionne	Adj:Mas+PL
additionnes	additionner	Ver:IPre+SG+P2:SPre+SG+P2
additionnes	additionner	Ver:PPas+Mas+PL
additionneur	additionneur	Nom:Mas+SG
additionnez	additionner	Ver:IPre+PL+P2:ImPre+PL+P2
additionniez	additionner	Ver:IImp+PL+P2:SPre+PL+P2
additionnions	additionner	Ver:IImp+PL+P1:SPre+PL+P1
additionnons	additionner	Ver:IPre+PL+P1:ImPre+PL+P1
additions	addition	Nom:Fem+PL
additive	additif	Adj:Fem+SG
additives	additif	Adj:Fem+PL
adducteur	adducteur	Adj:Mas+SG
adducteur	adducteur	Nom:Mas+SG
adduction	adduction	Nom:Fem+SG
adductions	adduction	Nom:Fem+PL
adele	adele	Nom:Fem+SG
adenite	adenite	Nom:Fem+SG
adenocarcinome	adenocarcinome	Nom:Mas+SG
adenogramme	adenogramme	Nom:Mas+SG
adenoide	adenoide	Adj:InvGen+SG
adenoidectomie	adenoidectomie	Nom:Fem+SG
adenomatose	adenomatose	Nom:Fem+SG
adenome	adenome	Nom:Mas+SG
adenopathie	adenopathie	Nom:Fem+SG
adenosine	adenosine	Nom:Fem+SG
adenovirus	adenovirus	Nom:Mas+InvPL
adent	adent	Nom:Mas+SG
adepte	adepte	Nom:InvGen+SG
adeptes	adepte	Nom:InvGen+PL
adequat	adequat	Adj:Mas+SG
adequate	adequat	Adj:Fem+SG
adequatement	adequatement	Adv
adequates	adequat	Adj:Fem+PL
adequation	adequation	Nom:Fem+SG
adequations	adequation	Nom:Fem+PL
adequats	adequat	Adj:Mas+PL
adermine	adermine	Nom:Fem+SG
adextre	adextre	Adj:Mas+SG
adextree	adextre	Adj:Fem+SG
adextrees	adextre	Adj:Fem+PL
adhera	adherer	Ver:IPSim+SG+P3
adherai	adherer	Ver:IPSim+SG+P1
adheraient	adherer	Ver:IImp+PL+P3
adherais	adherer	Ver:IImp+SG+P1:IImp+SG+P2
adherait	adherer	Ver:IImp+SG+P3
adherames	adherer	Ver:IPSim+PL+P1
adherant	adherer	Ver:PPre
adheras	adherer	Ver:IPSim+SG+P2
adherasse	adherer	Ver:SImp+SG+P1
adherassent	adherer	Ver:SImp+PL+P3
adherasses	adherer	Ver:SImp+SG+P2
adherassiez	adherer	Ver:SImp+PL+P2
adherassions	adherer	Ver:SImp+PL+P1
adherat	adherer	Ver:SImp+SG+P3
adherates	adherer	Ver:IPSim+PL+P2
adhere	adherer	Ver:IPre+SG+P1:IPre+SG+P3:SPre+SG+P1:SPre+SG+P3:ImPre+SG+P2
adhere	adherer	Ver:PPas+Mas+SG
adherence	adherence	Nom:Fem+SG
adherences	adherence	Nom:Fem+PL
adherent	adherent	Adj:Mas+SG
adherent	adherent	Nom:Mas+SG
adherent	adherer	Ver:IPre+PL+P3:SPre+PL+P3
adherente	adherent	Adj:Fem+SG
adherente	adherent	Nom:Fem+SG
adherentes	adherent	Adj:Fem+PL
adherentes	adherent	Nom:Fem+PL
adherents	adherent	Adj:Mas+PL
adherents	adherent	Nom:Mas+PL
adherera	adherer	Ver:IFut+SG+P3
adherer	adherer	Ver:Inf
adhererai	adherer	Ver:IFut+SG+P1
adhereraient	adherer	Ver:CPre+PL+P3
adhererais	adherer	Ver:CPre+SG+P1:CPre+SG+P2
adhererait	adherer	Ver:CPre+SG+P3
adhereras	adherer	Ver:IFut+SG+P2
adhererent	adherer	Ver:IPSim+PL+P3
adhererez	adherer	Ver:IFut+PL+P2
adhereriez	adherer	Ver:CPre+PL+P2
adhererions	adherer	Ver:CPre+PL+P1
adhererons	adherer	Ver:IFut+PL+P1
adhereront	adherer	Ver:IFut+PL+P3
adheres	adherer	Ver:IPre+SG+P2:SPre+SG+P2
adherez	adherer	Ver:IPre+PL+P2:ImPre+PL+P2
adheriez	adherer	Ver:IImp+PL+P2:SPre+PL+P2
adherions	adherer	Ver:IImp+PL+P1:SPre+PL+P1
adherons	adherer	Ver:IPre+PL+P1:ImPre+PL+P1
adhesif	adhesif	Adj:Mas+SG
adhesifs	adhesif	Adj:Mas+PL
adhesion	adhesion	Nom:Fem+SG
adhesions	adhesion	Nom:Fem+PL
adhesive	adhesif	Adj:Fem+SG
adhesives	adhesif	Adj:Fem+PL
adhesivite	adhesivite	Nom:Fem+SG
adiabatique	adiabatique	Adj:InvGen+SG
adiabatique	adiabatique	Nom:Fem+SG
adiabatiquement	adiabatiquement	Adv
adiantum	adiantum	Nom:Mas+SG
adiaphorese	adiaphorese	Nom:Fem+SG
adieu	adieu	Int
adieu	adieu	Nom:Mas+SG
adieux	adieu	Nom:Mas+PL
adipeuse	adipeux	Adj:Fem+SG
adipeuses	adipeux	Adj:Fem+PL
adipeux	adipeux	Adj:Mas+InvPL
adipique	adipique	Adj:InvGen+SG
adipolyse	adipolyse	Nom:Fem+SG
adipopexie	adipopexie	Nom:Fem+SG
adipose	adipose	Nom:Fem+SG
adiposite	adiposite	Nom:Fem+SG
adipsie	adipsie	Nom:Fem+SG
adire	adire	Adj:Mas+SG
adire	adirer	Ver:PPas+Mas+SG
adjacent	adjacent	Adj:Mas+SG
adjacente	adjacent	Adj:Fem+SG
adjacentes	adjacent	Adj:Fem+PL
adjacents	adjacent	Adj:Mas+PL
adjectif	adjectif	Adj:Mas+SG
adjectifs	adjectif	Adj:Mas+PL
adjectiva	adjectiver	Ver:IPSim+SG+P3
adjectivai	adjectiver	Ver:IPSim+SG+P1
adjectivaient	adjectiver	Ver:IImp+PL+P3
adjectivais	adjectiver	Ver:IImp+SG+P1:IImp+SG+P2
adjectivait	adjectiver	Ver:IImp+SG+P3
adjectival	adjectival	Adj:Mas+SG
adjectivale	adjectival	Adj:Fem+SG
adjectivales	adjectival	Adj:Fem+PL
adjectivames	adjectiver	Ver:IPSim+PL+P1
adjectivant	adjectiver	Ver:PPre
adjectivas	adjectiver	Ver:IPSim+SG+P2
adjectivasse	adjectiver	Ver:SImp+SG+P1
adjectivassent	adjectiver	Ver:SImp+PL+P3
adjectivasses	adjectiver	Ver:SImp+SG+P2
adjectivassiez	adjectiver	Ver:SImp+PL+P2
adjectivassions	adjectiver	Ver:SImp+PL+P1
adjectivat	adjectiver	Ver:SImp+SG+P3
adjectivates	adjectiver	Ver:IPSim+PL+P2
adjectivateur	adjectivateur	Nom:Mas+SG
adjectivation	adjectivation	Nom:Fem+SG
adjectivations	adjectivation	Nom:Fem+PL
adjectivaux	adjectival	Adj:Mas+PL
adjective	adjectif	Adj:Fem+SG
adjective	adjective	Adj:Mas+SG
adjective	adjectiver	Ver:IPre+SG+P1:IPre+SG+P3:SPre+SG+P1:SPre+SG+P3:ImPre+SG+P2
adjective	adjectiver	Ver:PPas+Mas+SG
adjectivement	adjectivement	Adv
adjectivent	adjectiver	Ver:IPre+PL+P3:SPre+PL+P3
adjectiver	adjectiver	Ver:Inf
adjectiverent	adjectiver	Ver:IPSim+PL+P3
adjectives	adjectif	Adj:Fem+PL
adjectives	adjectiver	Ver:IPre+SG+P2:SPre+SG+P2
adjectivez	adjectiver	Ver:IPre+PL+P2:ImPre+PL+P2
adjectiviez	adjectiver	Ver:IImp+PL+P2:SPre+PL+P2
adjectivions	adjectiver	Ver:IImp+PL+P1:SPre+PL+P1
adjectivons	adjectiver	Ver:IPre+PL+P1:ImPre+PL+P1
adjoignaient	adjoindre	Ver:IImp+PL+P3
adjoignais	adjoindre	Ver:IImp+SG+P1:IImp+SG+P2
adjoignait	adjoindre	Ver:IImp+SG+P3
adjoignant	adjoindre	Ver:PPre
adjoigne	adjoindre	Ver:SPre+SG+P1:SPre+SG+P3
adjoignent	adjoindre	Ver:IPre+PL+P3:SPre+PL+P3
adjoignes	adjoindre	Ver:SPre+SG+P2
adjoignez	adjoindre	Ver:IPre+PL+P2:ImPre+PL+P2
adjoigniez	adjoindre	Ver:IImp+PL+P2:SPre+PL+P2
adjoignimes	adjoindre	Ver:IPSim+PL+P1
adjoignions	adjoindre	Ver:IImp+PL+P1:SPre+PL+P1
adjoignirent	adjoindre	Ver:IPSim+PL+P3
adjoignis	adjoindre	Ver:IPSim+SG+P1:IPSim+SG+P2
adjoignisse	adjoindre	Ver:SImp+SG+P1
adjoignissent	adjoindre	Ver:SImp+PL+P3
adjoignisses	adjoindre	Ver:SImp+SG+P2
adjoignissiez	adjoindre	Ver:SImp+PL+P2
adjoignissions	adjoindre	Ver:SImp+PL+P1
adjoignit	adjoindre	Ver:IPSim+SG+P3
adjoignit	adjoindre	Ver:SImp+SG+P3
adjoignites	adjoindre	Ver:IPSim+PL+P2
adjoignons	adjoindre	Ver:IPre+PL+P1:ImPre+PL+P1
adjoindra	adjoindre	Ver:IFut+SG+P3
adjoindrai	adjoindre	Ver:IFut+SG+P1
adjoindraient	adjoindre	Ver:CPre+PL+P3
adjoindrais	adjoindre	Ver:CPre+SG+P1:CPre+SG+P2
adjoindrait	adjoindre	Ver:CPre+SG+P3
adjoindras	adjoindre	Ver:IFut+SG+P2
adjoindre	adjoindre	Ver:Inf
adjoindrez	adjoindre	Ver:IFut+PL+P2
adjoindriez	adjoindre	Ver:CPre+PL+P2
adjoindrions	adjoindre	Ver:CPre+PL+P1
adjoindrons	adjoindre	Ver:IFut+PL+P1
adjoindront	adjoindre	Ver:IFut+PL+P3
adjoins	adjoindre	Ver:IPre+SG+P1:IPre+SG+P2:ImPre+SG+P2
adjoint	adjoindre	Ver:PPas+Mas+SG:IPre+SG+P3
adjoint	adjoint	Adj:Mas+SG
adjoint	adjoint	Nom:Mas+SG
adjointe	adjoindre	Ver:PPas+Fem+SG
adjointe	adjoint	Adj:Fem+SG
adjointe	adjoint	Nom:Fem+SG
adjointes	adjoindre	Ver:PPas+Fem+PL
adjointes	adjoint	Adj:Fem+PL
adjointes	adjoint	Nom:Fem+PL
adjoints	adjoindre	Ver:PPas+Mas+PL
adjoints	adjoint	Adj:Mas+PL
adjoints	adjoint	Nom:Mas+PL
adjonction	adjonction	Nom:Fem+SG
adjonctions	adjonction	Nom:Fem+PL
adjudant	adjudant	Nom:Mas+SG
adjudants	adjudant	Nom:Mas+PL
adjudants-chefs	adjudant-chef	Nom:Mas+PL
adjudant-chef	adjudant-chef	Nom:Mas+SG
adjudicataire	adjudicataire	Nom:InvGen+SG
adjudicateur	adjudicateur	Nom:Mas+SG
adjudicatif	adjudicatif	Adj:Mas+SG
adjudication	adjudication	Nom:Fem+SG
adjudications	adjudication	Nom:Fem+PL
adjudicative	adjudicatif	Adj:Fem+SG
adjudicatives	adjudicatif	Adj:Fem+PL
adjudicatrice	adjudicateur	Nom:Fem+SG
adjugea	adjuger	Ver:IPSim+SG+P3
adjuge	adjuge	Adj:Mas+SG
adjuge	adjuger	Ver:IPre+SG+P1:IPre+SG+P3:SPre+SG+P1:SPre+SG+P3:ImPre+SG+P2
adjuge	adjuger	Ver:PPas+Mas+SG
adjugeai	adjuger	Ver:IPSim+SG+P1
adjugeaient	adjuger	Ver:IImp+PL+P3
adjugeais	adjuger	Ver:IImp+SG+P1
adjugeais	adjuger	Ver:IImp+SG+P2
adjugeait	adjuger	Ver:IImp+SG+P3
adjugeames	adjuger	Ver:IPSim+PL+P1
adjugeant	adjuger	Ver:PPre
adjugeas	adjuger	Ver:IPSim+SG+P2
adjugeasse	adjuger	Ver:SImp+SG+P1
adjugeassent	adjuger	Ver:SImp+PL+P3
adjugeasses	adjuger	Ver:SImp+SG+P2
adjugeassiez	adjuger	Ver:SImp+PL+P2
adjugeassions	adjuger	Ver:SImp+PL+P1
adjugeat	adjuger	Ver:SImp+SG+P3
adjugeates	adjuger	Ver:IPSim+PL+P2
adjugee	adjuger	Ver:PPas+Fem+SG
adjugees	adjuger	Ver:PPas+Fem+PL
adjugent	adjuger	Ver:IPre+PL+P3:SPre+PL+P3
adjugeons	adjuger	Ver:Imp+PL+P1
adjugeons	adjuger	Ver:IPre+PL+P1
adjugera	adjuger	Ver:IFut+SG+P3
adjuger	adjuger	Ver:Inf
adjugerai	adjuger	Ver:IFut+SG+P1
adjugeraient	adjuger	Ver:CPre+PL+P3
adjugerais	adjuger	Ver:CPre+SG+P1:CPre+SG+P2
adjugerait	adjuger	Ver:CPre+SG+P3
adjugeras	adjuger	Ver:IFut+SG+P2
adjugerent	adjuger	Ver:IPSim+PL+P3
adjugerez	adjuger	Ver:IFut+PL+P2
adjugeriez	adjuger	Ver:CPre+PL+P2
adjugerions	adjuger	Ver:CPre+PL+P1
adjugerons	adjuger	Ver:IFut+PL+P1
adjugeront	adjuger	Ver:IFut+PL+P3
adjuges	adjuger	Ver:IPre+SG+P2:SPre+SG+P2
adjuges	adjuger	Ver:PPas+Mas+PL
adjugez	adjuger	Ver:Imp+PL+P2
adjugez	adjuger	Ver:IPre+PL+P2
adjugiez	adjuger	Ver:IImp+PL+P2:SPre+PL+P2
adjugions	adjuger	Ver:IImp+PL+P1:SPre+PL+P1
adjura	adjurer	Ver:IPSim+SG+P3
adjurai	adjurer	Ver:IPSim+SG+P1
adjuraient	adjurer	Ver:IImp+PL+P3
adjurais	adjurer	Ver:IImp+SG+P1:IImp+SG+P2
adjurait	adjurer	Ver:IImp+SG+P3
adjurames	adjurer	Ver:IPSim+PL+P1
adjurant	adjurer	Ver:PPre
adjuras	adjurer	Ver:IPSim+SG+P2
adjurasse	adjurer	Ver:SImp+SG+P1
adjurassent	adjurer	Ver:SImp+PL+P3
adjurasses	adjurer	Ver:SImp+SG+P2
adjurassiez	adjurer	Ver:SImp+PL+P2
adjurassions	adjurer	Ver:SImp+PL+P1
adjurat	adjurer	Ver:SImp+SG+P3
adjurates	adjurer	Ver:IPSim+PL+P2
adjuration	adjuration	Nom:Fem+SG
adjurations	adjuration	Nom:Fem+PL
adjure	adjurer	Ver:IPre+SG+P1:IPre+SG+P3:SPre+SG+P1:SPre+SG+P3:ImPre+SG+P2
adjure	adjurer	Ver:PPas+Mas+SG
adjuree	adjurer	Ver:PPas+Fem+SG
adjurees	adjurer	Ver:PPas+Fem+PL
adjurent	adjurer	Ver:IPre+PL+P3:SPre+PL+P3
adjurera	adjurer	Ver:IFut+SG+P3
adjurer	adjurer	Ver:Inf
adjurerai	adjurer	Ver:IFut+SG+P1
adjureraient	adjurer	Ver:CPre+PL+P3
adjurerais	adjurer	Ver:CPre+SG+P1:CPre+SG+P2
adjurerait	adjurer	Ver:CPre+SG+P3
adjureras	adjurer	Ver:IFut+SG+P2
adjurerent	adjurer	Ver:IPSim+PL+P3
adjurerez	adjurer	Ver:IFut+PL+P2
adjureriez	adjurer	Ver:CPre+PL+P2
adjurerions	adjurer	Ver:CPre+PL+P1
adjurerons	adjurer	Ver:IFut+PL+P1
adjureront	adjurer	Ver:IFut+PL+P3
adjures	adjurer	Ver:IPre+SG+P2:SPre+SG+P2
adjures	adjurer	Ver:PPas+Mas+PL
adjurez	adjurer	Ver:IPre+PL+P2:ImPre+PL+P2
adjuriez	adjurer	Ver:IImp+PL+P2:SPre+PL+P2
adjurions	adjurer	Ver:IImp+PL+P1:SPre+PL+P1
adjurons	adjurer	Ver:IPre+PL+P1:ImPre+PL+P1
adjuvant	adjuvant	Nom:Mas+SG
adjuvant	adjuver	Ver:PPre
adjuvante	adjuvant	Adj:Fem+SG
adjuvantes	adjuvant	Adj:Fem+PL
adjuvants	adjuvant	Nom:Mas+PL
adjuvat	adjuvat	Nom:Mas+SG
admet	admettre	Ver:IPre+SG+P3
admets	admettre	Ver:IPre+SG+P1:IPre+SG+P2:ImPre+SG+P2
admettaient	admettre	Ver:IImp+PL+P3
admettais	admettre	Ver:IImp+SG+P1:IImp+SG+P2
admettait	admettre	Ver:IImp+SG+P3
admettant	admettre	Ver:PPre
admette	admettre	Ver:SPre+SG+P1:SPre+SG+P3
admettent	admettre	Ver:IPre+PL+P3:SPre+PL+P3
admettes	admettre	Ver:SPre+SG+P2
admettez	admettre	Ver:IPre+PL+P2:ImPre+PL+P2
admettiez	admettre	Ver:IImp+PL+P2:SPre+PL+P2
admettions	admettre	Ver:IImp+PL+P1:SPre+PL+P1
admettons	admettre	Ver:IPre+PL+P1:ImPre+PL+P1
admettra	admettre	Ver:IFut+SG+P3
admettrai	admettre	Ver:IFut+SG+P1
admettraient	admettre	Ver:CPre+PL+P3
admettrais	admettre	Ver:CPre+SG+P1:CPre+SG+P2
admettrait	admettre	Ver:CPre+SG+P3
admettras	admettre	Ver:IFut+SG+P2
admettre	admettre	Ver:Inf
admettrez	admettre	Ver:IFut+PL+P2
admettriez	admettre	Ver:CPre+PL+P2
admettrions	admettre	Ver:CPre+PL+P1
admettrons	admettre	Ver:IFut+PL+P1
admettront	admettre	Ver:IFut+PL+P3
admimes	admettre	Ver:IPSim+PL+P1
adminicule	adminicule	Nom:Mas+SG
administra	administrer	Ver:IPSim+SG+P3
administrable	administrable	Adj:InvGen+SG
administrai	administrer	Ver:IPSim+SG+P1
administraient	administrer	Ver:IImp+PL+P3
administrais	administrer	Ver:IImp+SG+P1:IImp+SG+P2
administrait	administrer	Ver:IImp+SG+P3
administrames	administrer	Ver:IPSim+PL+P1
administrant	administrer	Ver:PPre
administras	administrer	Ver:IPSim+SG+P2
administrasse	administrer	Ver:SImp+SG+P1
administrassent	administrer	Ver:SImp+PL+P3
administrasses	administrer	Ver:SImp+SG+P2
administrassiez	administrer	Ver:SImp+PL+P2
administrassions	administrer	Ver:SImp+PL+P1
administrat	administrer	Ver:SImp+SG+P3
administrates	administrer	Ver:IPSim+PL+P2
administrateur	administrateur	Nom:Mas+SG
administrateurs	administrateur	Nom:Mas+PL
administratif	administratif	Adj:Mas+SG
administratif	administratif	Nom:Mas+SG
administratifs	administratif	Adj:Mas+PL
administratifs	administratif	Nom:Mas+PL
administration	administration	Nom:Fem+SG
administrations	administration	Nom:Fem+PL
administrative	administratif	Adj:Fem+SG
administrative	administratif	Nom:Fem+SG
administrativement	administrativement	Adv
administratives	administratif	Adj:Fem+PL
administratives	administratif	Nom:Fem+PL
administratrice	administrateur	Nom:Fem+SG
administratrices	administrateur	Nom:Fem+PL
administre	administre	Adj:Mas+SG
administre	administre	Nom:Mas+SG
administre	administrer	Ver:IPre+SG+P1:IPre+SG+P3:SPre+SG+P1:SPre+SG+P3:ImPre+SG+P2
administre	administrer	Ver:PPas+Mas+SG
administree	administre	Adj:Fem+SG
administree	administre	Nom:Fem+SG
administree	administrer	Ver:PPas+Fem+SG
administrees	administre	Adj:Fem+PL
administrees	administre	Nom:Fem+PL
administrees	administrer	Ver:PPas+Fem+PL
administrent	administrer	Ver:IPre+PL+P3:SPre+PL+P3
administrera	administrer	Ver:IFut+SG+P3
administrer	administrer	Ver:Inf
administrerai	administrer	Ver:IFut+SG+P1
administreraient	administrer	Ver:CPre+PL+P3
administrerais	administrer	Ver:CPre+SG+P1:CPre+SG+P2
administrerait	administrer	Ver:CPre+SG+P3
administreras	administrer	Ver:IFut+SG+P2
administrerent	administrer	Ver:IPSim+PL+P3
administrerez	administrer	Ver:IFut+PL+P2
administreriez	administrer	Ver:CPre+PL+P2
administrerions	administrer	Ver:CPre+PL+P1
administrerons	administrer	Ver:IFut+PL+P1
administreront	administrer	Ver:IFut+PL+P3
administres	administre	Adj:Mas+PL
administres	administre	Nom:Mas+PL
administres	administrer	Ver:IPre+SG+P2:SPre+SG+P2
administres	administrer	Ver:PPas+Mas+PL
administrez	administrer	Ver:IPre+PL+P2:ImPre+PL+P2
administriez	administrer	Ver:IImp+PL+P2:SPre+PL+P2
administrions	administrer	Ver:IImp+PL+P1:SPre+PL+P1
administrons	administrer	Ver:IPre+PL+P1:ImPre+PL+P1
admira	admirer	Ver:IPSim+SG+P3
admirable	admirable	Adj:InvGen+SG
admirablement	admirablement	Adv
admirables	admirable	Adj:InvGen+PL
admirai	admirer	Ver:IPSim+SG+P1
admiraient	admirer	Ver:IImp+PL+P3
admirais	admirer	Ver:IImp+SG+P1:IImp+SG+P2
admirait	admirer	Ver:IImp+SG+P3
admirames	admirer	Ver:IPSim+PL+P1
admirant	admirant	Adj:Mas+SG
admirant	admirer	Ver:PPre
admiras	admirer	Ver:IPSim+SG+P2
admirasse	admirer	Ver:SImp+SG+P1
admirassent	admirer	Ver:SImp+PL+P3
admirasses	admirer	Ver:SImp+SG+P2
admirassiez	admirer	Ver:SImp+PL+P2
admirassions	admirer	Ver:SImp+PL+P1
admirat	admirer	Ver:SImp+SG+P3
admirates	admirer	Ver:IPSim+PL+P2
admirateur	admirateur	Adj:Mas+SG
admirateurs	admirateur	Adj:Mas+PL
admiratif	admiratif	Adj:Mas+SG
admiratifs	admiratif	Adj:Mas+PL
admiration	admiration	Nom:Fem+SG
admirations	admiration	Nom:Fem+PL
admirative	admiratif	Adj:Fem+SG
admirativement	admirativement	Adv
admiratives	admiratif	Adj:Fem+PL
admiratrice	admirateur	Adj:Fem+SG
admiratrice	admirateur	Nom:Fem+SG
admiratrices	admirateur	Adj:Fem+PL
admiratrices	admirateur	Nom:Fem+PL
admire	admirer	Ver:Imp+SG+P2
admire	admirer	Ver:IPre+SG+P1
admire	admirer	Ver:IPre+SG+P3
admire	admirer	Ver:PPas+Mas+SG
admire	admirer	Ver:SPre+SG+P1
admire	admirer	Ver:SPre+SG+P3
admiree	admirer	Ver:PPas+Fem+SG
admirees	admirer	Ver:PPas+Fem+PL
admirent	admettre	Ver:IPSim+PL+P3
admirent	admirer	Ver:IPre+PL+P3:SPre+PL+P3
admirera	admirer	Ver:IFut+SG+P3
admirer	admirer	Ver:Inf
admirerai	admirer	Ver:IFut+SG+P1
admireraient	admirer	Ver:CPre+PL+P3
admirerais	admirer	Ver:CPre+SG+P1
admirerais	admirer	Ver:CPre+SG+P2
admirerait	admirer	Ver:CPre+SG+P3
admireras	admirer	Ver:IFut+SG+P2
admirerent	admirer	Ver:IPSim+PL+P3
admirerez	admirer	Ver:IFut+PL+P2
admireriez	admirer	Ver:CPre+PL+P2
admirerions	admirer	Ver:CPre+PL+P1
admirerons	admirer	Ver:IFut+PL+P1
admireront	admirer	Ver:IFut+PL+P3
admires	admirer	Ver:IPre+SG+P2
admires	admirer	Ver:PPas+Mas+PL
admires	admirer	Ver:SPre+SG+P2
admirez	admirer	Ver:IPre+PL+P2:ImPre+PL+P2
admiriez	admirer	Ver:IImp+PL+P2:SPre+PL+P2
admirions	admirer	Ver:IImp+PL+P1:SPre+PL+P1
admirons	admirer	Ver:IPre+PL+P1:ImPre+PL+P1
admis	admettre	Ver:PPas+Mas+SG:PPas+Mas+PL:IPSim+SG+P1:IPSim+SG+P2
admis	admettre	Ver:PPas+Mas+SG:IPSim+SG+P1:IPSim+SG+P2
admis	admis	Nom:Mas+InvPL
admise	admettre	Ver:PPas+Fem+SG
admise	admis	Nom:Fem+SG
admises	admettre	Ver:PPas+Fem+PL
admises	admis	Nom:Fem+PL
admisse	admettre	Ver:SImp+SG+P1
admissent	admettre	Ver:SImp+PL+P3
admisses	admettre	Ver:SImp+SG+P2
admissibilite	admissibilite	Nom:Fem+SG
admissibilites	admissibilite	Nom:Fem+PL
admissible	admissible	Adj:InvGen+SG
admissible	admissible	Nom:InvGen+SG
admissibles	admissible	Adj:InvGen+PL
admissibles	admissible	Nom:InvGen+PL
admissiez	admettre	Ver:SImp+PL+P2
admission	admission	Nom:Fem+SG
admissions	admettre	Ver:SImp+PL+P1
admissions	admission	Nom:Fem+PL
admit	admettre	Ver:IPSim+SG+P3
admit	admettre	Ver:SImp+SG+P3
admites	admettre	Ver:IPSim+PL+P2
admittance	admittance	Nom:Fem+SG
admittatur	admittatur	Nom:Mas+SG
admixtion	admixtion	Nom:Fem+SG
admonesta	admonester	Ver:IPSim+SG+P3
admonestai	admonester	Ver:IPSim+SG+P1
admonestaient	admonester	Ver:IImp+PL+P3
admonestais	admonester	Ver:IImp+SG+P1:IImp+SG+P2
admonestait	admonester	Ver:IImp+SG+P3
admonestames	admonester	Ver:IPSim+PL+P1
admonestant	admonester	Ver:PPre
admonestas	admonester	Ver:IPSim+SG+P2
admonestasse	admonester	Ver:SImp+SG+P1
admonestassent	admonester	Ver:SImp+PL+P3
admonestasses	admonester	Ver:SImp+SG+P2
admonestassiez	admonester	Ver:SImp+PL+P2
admonestassions	admonester	Ver:SImp+PL+P1
admonestat	admonester	Ver:SImp+SG+P3
admonestates	admonester	Ver:IPSim+PL+P2
admonestation	admonestation	Nom:Fem+SG
admonestations	admonestation	Nom:Fem+PL
admoneste	admonester	Ver:IPre+SG+P1:IPre+SG+P3:SPre+SG+P1:SPre+SG+P3:ImPre+SG+P2
admoneste	admonester	Ver:PPas+Mas+SG
admonestent	admonester	Ver:IPre+PL+P3:SPre+PL+P3
admonester	admonester	Ver:Inf
admonesterent	admonester	Ver:IPSim+PL+P3
admonestes	admonester	Ver:IPre+SG+P2:SPre+SG+P2
admonestez	admonester	Ver:IPre+PL+P2:ImPre+PL+P2
admonestiez	admonester	Ver:IImp+PL+P2:SPre+PL+P2
admonestions	admonester	Ver:IImp+PL+P1:SPre+PL+P1
admonestons	admonester	Ver:IPre+PL+P1:ImPre+PL+P1
admonition	admonition	Nom:Fem+SG
adne	adne	Adj:Mas+SG
adnee	adne	Adj:Fem+SG
adnees	adne	Adj:Fem+PL
adnominal	adnominal	Adj:Mas+SG
adobe	adobe	Nom:Mas+SG
adolescence	adolescence	Nom:Fem+SG
adolescent	adolescent	Adj:Mas+SG
adolescent	adolescent	Nom:Mas+SG
adolescente	adolescent	Adj:Fem+SG
adolescente	adolescent	Nom:Fem+SG
adolescentes	adolescent	Adj:Fem+PL
adolescentes	adolescent	Nom:Fem+PL
adolescents	adolescent	Adj:Mas+PL
adolescents	adolescent	Nom:Mas+PL
adonis	adonis	Nom:Fem+InvPL
adonis	adonis	Nom:Mas+InvPL
adoniser	adoniser	Ver:Inf
adonna	adonner	Ver:IPSim+SG+P3
adonnai	adonner	Ver:IPSim+SG+P1
adonnaient	adonner	Ver:IImp+PL+P3
adonnais	adonner	Ver:IImp+SG+P1:IImp+SG+P2
adonnait	adonner	Ver:IImp+SG+P3
adonnames	adonner	Ver:IPSim+PL+P1
adonnant	adonner	Ver:PPre
adonnas	adonner	Ver:IPSim+SG+P2
adonnasse	adonner	Ver:SImp+SG+P1
adonnassent	adonner	Ver:SImp+PL+P3
adonnasses	adonner	Ver:SImp+SG+P2
adonnassiez	adonner	Ver:SImp+PL+P2
adonnassions	adonner	Ver:SImp+PL+P1
adonnat	adonner	Ver:SImp+SG+P3
adonnates	adonner	Ver:IPSim+PL+P2
adonne	adonner	Ver:IPre+SG+P1:IPre+SG+P3:SPre+SG+P1:SPre+SG+P3:ImPre+SG+P2
adonne	adonner	Ver:PPas+Mas+SG
adonnee	adonner	Ver:PPas+Fem+SG
adonnees	adonner	Ver:PPas+Fem+PL
adonnent	adonner	Ver:IPre+PL+P3:SPre+PL+P3
adonnera	adonner	Ver:IFut+SG+P3
adonner	adonner	Ver:Inf
adonnerai	adonner	Ver:IFut+SG+P1
adonneraient	adonner	Ver:CPre+PL+P3
adonnerais	adonner	Ver:CPre+SG+P1:CPre+SG+P2
adonnerait	adonner	Ver:CPre+SG+P3
adonneras	adonner	Ver:IFut+SG+P2
adonnerent	adonner	Ver:IPSim+PL+P3
adonnerez	adonner	Ver:IFut+PL+P2
adonneriez	adonner	Ver:CPre+PL+P2
adonnerions	adonner	Ver:CPre+PL+P1
adonnerons	adonner	Ver:IFut+PL+P1
adonneront	adonner	Ver:IFut+PL+P3
adonnes	adonner	Ver:IPre+SG+P2:SPre+SG+P2
adonnes	adonner	Ver:PPas+Mas+PL
adonnez	adonner	Ver:IPre+PL+P2:ImPre+PL+P2
adonniez	adonner	Ver:IImp+PL+P2:SPre+PL+P2
adonnions	adonner	Ver:IImp+PL+P1:SPre+PL+P1
adonnons	adonner	Ver:IPre+PL+P1:ImPre+PL+P1
adopta	adopter	Ver:IPSim+SG+P3
adoptable	adoptable	Adj:InvGen+SG
adoptai	adopter	Ver:IPSim+SG+P1
adoptaient	adopter	Ver:IImp+PL+P3
adoptais	adopter	Ver:IImp+SG+P1:IImp+SG+P2
adoptait	adopter	Ver:IImp+SG+P3
adoptames	adopter	Ver:IPSim+PL+P1
adoptant	adoptant	Adj:Mas+SG
adoptant	adoptant	Nom:Mas+SG
adoptant	adopter	Ver:PPre
adoptante	adoptant	Adj:Fem+SG
adoptante	adoptant	Nom:Fem+SG
adoptantes	adoptant	Adj:Fem+PL
adoptantes	adoptant	Nom:Fem+PL
adoptas	adopter	Ver:IPSim+SG+P2
adoptasse	adopter	Ver:SImp+SG+P1
adoptassent	adopter	Ver:SImp+PL+P3
adoptasses	adopter	Ver:SImp+SG+P2
adoptassiez	adopter	Ver:SImp+PL+P2
adoptassions	adopter	Ver:SImp+PL+P1
adoptat	adopter	Ver:SImp+SG+P3
adoptates	adopter	Ver:IPSim+PL+P2
adopte	adopte	Adj:Mas+SG
adopte	adopte	Nom:Mas+SG
adopte	adopter	Ver:IPre+SG+P1:IPre+SG+P3:SPre+SG+P1:SPre+SG+P3:ImPre+SG+P2
adopte	adopter	Ver:PPas+Mas+SG
adoptee	adopte	Adj:Fem+SG
adoptee	adopte	Nom:Fem+SG
adoptee	adopter	Ver:PPas+Fem+SG
adoptees	adopte	Adj:Fem+PL
adoptees	adopte	Nom:Fem+PL
adoptees	adopter	Ver:PPas+Fem+PL
adoptent	adopter	Ver:IPre+PL+P3:SPre+PL+P3
